AAAAACTATCT -> AAAACTATCTT
AAAAAGCCGAC -> AAAAGCCGACG
AAAACTATCTT -> AAACTATCTTG
AAAACTCGTAC -> AAACTCGTACC
AAAAGCCGACG -> AAAGCCGACGC
AAAAGCTCTGA -> AAAGCTCTGAA
AAACAATCCTT -> AACAATCCTTA
AAACACAGACT -> AACACAGACTG
AAACAGCCGGT -> AACAGCCGGTA
AAACATATGAT -> AACATATGATC
AAACCCCTTAG -> AACCCCTTAGG
AAACCTGTAAT -> AACCTGTAATC
AAACGACTTGT -> AACGACTTGTG
AAACGGAAATG -> AACGGAAATGG
AAACTATCTTG -> AACTATCTTGT
AAACTCAGGTT -> AACTCAGGTTG
AAACTCGTACC -> AACTCGTACCT
AAAGATCTTAT -> AAGATCTTATA
AAAGCCGACGC -> AAGCCGACGCA
AAAGCTCTGAA -> AAGCTCTGAAG
AAAGGGAAAAA -> AAGGGAAAAAC
AAATCCGAGTC -> AATCCGAGTCT
AAATCTCATGC -> AATCTCATGCA
AAATGAGGGAG -> AATGAGGGAGC
AAATGGCATCA -> AATGGCATCAA
AAATGGCGCGC -> AATGGCGCGCC
AAATTAGCCGT -> AATTAGCCGTC
AAATTCATGGG -> AATTCATGGGA
AAATTCTTGTA -> AATTCTTGTAA
AACAAACACAG -> ACAAACACAGA
AACAACGCGAC -> ACAACGCGACA
AACAACTGTTT -> ACAACTGTTTG
AACAATCCTTA -> ACAATCCTTAT
AACACAGACTG -> ACACAGACTGA
AACAGCCCACT -> ACAGCCCACTC
AACAGCCGGTA -> ACAGCCGGTAC
AACAGGTTTCC -> ACAGGTTTCCG
AACATATGATC -> ACATATGATCC
AACCATCGTAT -> ACCATCGTATG
AACCCCTTAGG -> ACCCCTTAGGT
AACCGCCATGG -> ACCGCCATGGA
AACCTAACCTA -> ACCTAACCTAT
AACCTATCGGG -> ACCTATCGGGG
AACCTGTAATC -> ACCTGTAATCT
AACGAAGGAGG -> ACGAAGGAGGC
AACGACTTGTG -> ACGACTTGTGC
AACGCGACAGG -> ACGCGACAGGT
AACGCGACATT -> ACGCGACATTC
AACGCTCTCAG -> ACGCTCTCAGG
AACGGAAATGG -> ACGGAAATGGC
AACGGCTCCCG -> ACGGCTCCCGG
AACGGGACGGT -> ACGGGACGGTT
AACGTACATTG -> ACGTACATTGT
AACTAACTTCG -> ACTAACTTCGG
AACTACCTACT -> ACTACCTACTA
AACTAGTTTAG -> ACTAGTTTAGC
AACTATCTTGT -> ACTATCTTGTA
AACTCAGGTTG -> ACTCAGGTTGA
AACTCGTACCT -> ACTCGTACCTC
AACTGTTTGAT -> ACTGTTTGATA
AACTTATTCGA -> ACTTATTCGAT
AACTTCGGGAC -> ACTTCGGGACA
AACTTGCATAA -> ACTTGCATAAG
AAGAAAGGGAA -> AGAAAGGGAAA
AAGAACGCGAC -> AGAACGCGACA
AAGAAGAGGGC -> AGAAGAGGGCC
AAGAGCGGGGC -> AGAGCGGGGCC
AAGAGGGCCGT -> AGAGGGCCGTG
AAGATACGTCC -> AGATACGTCCC
AAGATCTTATA -> AGATCTTATAC
AAGCACTCGGA -> AGCACTCGGAA
AAGCCGACGCA -> AGCCGACGCAT
AAGCCGCAACT -> AGCCGCAACTA
AAGCTCTGAAG -> AGCTCTGAAGC
AAGCTGGTCCC -> AGCTGGTCCCC
AAGCTTAGACC -> AGCTTAGACCA
AAGCTTGCAGA -> AGCTTGCAGAT
AAGGAAGGATA -> AGGAAGGATAA
AAGGAGGCGAA -> AGGAGGCGAAC
AAGGATAATGT -> AGGATAATGTA
AAGGCACGATC -> AGGCACGATCC
AAGGGAAAAAC -> AGGGAAAAACT
AAGGTAACTTG -> AGGTAACTTGC
AAGGTCCGAAC -> AGGTCCGAACC
AAGGTCCTCTC -> AGGTCCTCTCT
AAGGTGCAGGA -> AGGTGCAGGAG
AAGGTTATGAG -> AGGTTATGAGC
AAGTACCTCCC -> AGTACCTCCCC
AAGTAGGTTGG -> AGTAGGTTGGT
AAGTCCACTGA -> AGTCCACTGAT
AAGTCTCGGTC -> AGTCTCGGTCT
AAGTGGTCCTG -> AGTGGTCCTGT
AAGTTCAAACC -> AGTTCAAACCT
AAGTTGGATTG -> AGTTGGATTGG
AATAAACGGAA -> ATAAACGGAAA
AATAGTTACGC -> ATAGTTACGCT
AATATCGAGGT -> ATATCGAGGTG
AATCACCCAGG -> ATCACCCAGGT
AATCCGAGTCT -> ATCCGAGTCTG
AATCCGCGGCT -> ATCCGCGGCTC
AATCCTTATAT -> ATCCTTATATG
AATCTAGACCA -> ATCTAGACCAC
AATCTCACGCT -> ATCTCACGCTA
AATCTCATGCA -> ATCTCATGCAC
AATCTCGTAAA -> ATCTCGTAAAA
AATCTTCCGAT -> ATCTTCCGATT
AATGAAGATAC -> ATGAAGATACG
AATGAGGGAGC -> ATGAGGGAGCC
AATGGCATCAA -> ATGGCATCAAG
AATGGCGCGCC -> ATGGCGCGCCA
AATGTAAATTC -> ATGTAAATTCA
AATTAGCCGTC -> ATTAGCCGTCT
AATTCATGGGA -> ATTCATGGGAA
AATTCTATATG -> ATTCTATATGC
AATTCTTGTAA -> ATTCTTGTAAT
AATTTACGCCA -> ATTTACGCCAG
AATTTCACTCT -> ATTTCACTCTT
AATTTCCGCAC -> ATTTCCGCACA
ACAAACACAGA -> CAAACACAGAC
ACAAATCCGAG -> CAAATCCGAGT
ACAAATCTCAT -> CAAATCTCATG
ACAACGCGACA -> CAACGCGACAG
ACAACTGTTTG -> CAACTGTTTGA
ACAAGGTAACT -> CAAGGTAACTT
ACAATCCTTAT -> CAATCCTTATA
ACACAGACTGA -> CACAGACTGAT
ACACATGCTGT -> CACATGCTGTC
ACACGATAAAT -> CACGATAAATG
ACACGGCGGAA -> CACGGCGGAAG
ACACGGGCATA -> CACGGGCATAA
ACACTAAGAAA -> CACTAAGAAAG
ACAGAAAGATC -> CAGAAAGATCT
ACAGACGGCTG -> CAGACGGCTGG
ACAGACTGATT -> CAGACTGATTG
ACAGCCCACTC -> CAGCCCACTCA
ACAGCCGGTAC -> CAGCCGGTACA
ACAGCTCGATC -> CAGCTCGATCG
ACAGGGCCCTG -> CAGGGCCCTGG
ACAGGTCGCAA -> CAGGTCGCAAT
ACAGGTTTCCC -> CAGGTTTCCCA
ACAGGTTTCCG -> CAGGTTTCCGG
ACAGTAGGGGT -> CAGTAGGGGTA
ACAGTAGGTGG -> CAGTAGGTGGG
ACAGTTAATCC -> CAGTTAATCCG
ACAGTTGTATT -> CAGTTGTATTG
ACATATGATCC -> CATATGATCCA
ACATCGTGTGG -> CATCGTGTGGG
ACATGCTGTCG -> CATGCTGTCGT
ACATTAGACCG -> CATTAGACCGC
ACATTCGAAGG -> CATTCGAAGGT
ACATTCTCGGC -> CATTCTCGGCG
ACATTGCTCCG -> CATTGCTCCGA
ACATTGTCTGC -> CATTGTCTGCA
ACCAAAAAGCC -> CCAAAAAGCCG
ACCACAGCTCG -> CCACAGCTCGA
ACCACCACTGA -> CCACCACTGAT
ACCACTGATGT -> CCACTGATGTA
ACCAGGCCTCG -> CCAGGCCTCGG
ACCATAGTTAC -> CCATAGTTACC
ACCATCGTATG -> CCATCGTATGT
ACCCAGGTATC -> CCCAGGTATCC
ACCCCTTAGGT -> CCCCTTAGGTT
ACCCGTGAGCG -> CCCGTGAGCGG
ACCGCAACCTA -> CCGCAACCTAA
ACCGCCATGGA -> CCGCCATGGAT
ACCGCTCCGAA -> CCGCTCCGAAG
ACCGGTCACGG -> CCGGTCACGGT
ACCTAACCTAT -> CCTAACCTATC
ACCTACTAATA -> CCTACTAATAA
ACCTAGCGATC -> CCTAGCGATCT
ACCTATCGGGG -> CCTATCGGGGT
ACCTCCCCCTA -> CCTCCCCCTAA,CCTCCCCCTAG
ACCTCTCCATC -> CCTCTCCATCG
ACCTGACCGCT -> CCTGACCGCTC
ACCTGTAATCT -> CCTGTAATCTC
ACCTTCATACC -> CCTTCATACCT
ACCTTTCTTTA -> CCTTTCTTTAT
ACGAAATTCTT -> CGAAATTCTTG
ACGAAGGAGGC -> CGAAGGAGGCG
ACGAATTTCCG -> CGAATTTCCGC
ACGACTTGTGC -> CGACTTGTGCA
ACGAGGGCTCA -> CGAGGGCTCAC
ACGAGTATCCC -> CGAGTATCCCC
ACGATAAATGA -> CGATAAATGAG
ACGATCCGAAC -> CGATCCGAACA
ACGATTCCTGC -> CGATTCCTGCT
ACGCATTTGCG -> CGCATTTGCGG
ACGCCAGTTCT -> CGCCAGTTCTA
ACGCCCCAGCG -> CGCCCCAGCGT
ACGCCGCGCCT -> CGCCGCGCCTG
ACGCGACAGGT -> CGCGACAGGTT
ACGCGACATTC -> CGCGACATTCT
ACGCGGAGATC -> CGCGGAGATCG
ACGCTAAGCTG -> CGCTAAGCTGG
ACGCTACGGGT -> CGCTACGGGTA
ACGCTCAGGCA -> CGCTCAGGCAC
ACGCTCTCAGG -> CGCTCTCAGGC
ACGCTGCAGGG -> CGCTGCAGGGC
ACGGAAATGGC -> CGGAAATGGCG
ACGGACTACGC -> CGGACTACGCG
ACGGCGGAAGG -> CGGCGGAAGGT
ACGGCTCCCGG -> CGGCTCCCGGA
ACGGCTGGAGA -> CGGCTGGAGAG
ACGGGACGGTT -> CGGGACGGTTG
ACGGGCATAAC -> CGGGCATAACG
ACGGGTAGTCC -> CGGGTAGTCCT
ACGGTCGCCAG -> CGGTCGCCAGA
ACGGTCTGGTT -> CGGTCTGGTTT
ACGGTGGCATC -> CGGTGGCATCA
ACGGTTGCCAG -> CGGTTGCCAGG
ACGTACATTGT -> CGTACATTGTC
ACGTCCCATTC -> CGTCCCATTCA
ACGTGGCCCGA -> CGTGGCCCGAT
ACGTTCGGCTA -> CGTTCGGCTAT
ACGTTTGAAAC -> CGTTTGAAACA
ACTAACTTCGG -> CTAACTTCGGG
ACTAAGAAAGG -> CTAAGAAAGGG
ACTAATAAACG -> CTAATAAACGG
ACTACCTACTA -> CTACCTACTAA
ACTACGCGGAG -> CTACGCGGAGA
ACTACGTTCGG -> CTACGTTCGGC
ACTAGTTTAGC -> CTAGTTTAGCG
ACTATCTTGTA -> CTATCTTGTAA
ACTCAGCTCCT -> CTCAGCTCCTG
ACTCAGGTTGA -> CTCAGGTTGAC
ACTCCCAGAAA -> CTCCCAGAAAA
ACTCGGAACAG -> CTCGGAACAGC
ACTCGTACCTC -> CTCGTACCTCC
ACTCTTGCGGG -> CTCTTGCGGGA
ACTGAACGGGA -> CTGAACGGGAC
ACTGACAGTAG -> CTGACAGTAGG
ACTGATGCTCC -> CTGATGCTCCC
ACTGATGTAAA -> CTGATGTAAAC
ACTGATTGAGT -> CTGATTGAGTC
ACTGGATCTCG -> CTGGATCTCGC
ACTGTAATTTC -> CTGTAATTTCA
ACTGTCCATTA -> CTGTCCATTAC
ACTGTTTGATA -> CTGTTTGATAT
ACTTATTCGAT -> CTTATTCGATC
ACTTCGGGACA -> CTTCGGGACAG
ACTTGCATAAG -> CTTGCATAAGC
ACTTGTGCAGC -> CTTGTGCAGCG
ACTTTTTACAG -> CTTTTTACAGT
AGAAAACTCGT -> GAAAACTCGTA
AGAAAGATCTT -> GAAAGATCTTA
AGAAAGGGAAA -> GAAAGGGAAAA
AGAACGCGACA -> GAACGCGACAT
AGAAGAGGGCC -> GAAGAGGGCCG
AGAAGGCACGA -> GAAGGCACGAT
AGAAGTCTCGG -> GAAGTCTCGGT
AGAATCTCACG -> GAATCTCACGC
AGACCAAAAAG -> GACCAAAAAGC
AGACCACAGCT -> GACCACAGCTC
AGACCGCAACC -> GACCGCAACCT
AGACGAAATTC -> GACGAAATTCT
AGACGGCTGGA -> GACGGCTGGAG
AGACTGATTGA -> GACTGATTGAG
AGAGAGCTTTC -> GAGAGCTTTCT
AGAGCGGGGCC -> GAGCGGGGCCA
AGAGCTTTCTT -> GAGCTTTCTTC
AGAGGGCCGTG -> GAGGGCCGTGC
AGAGTACTGAC -> GAGTACTGACA
AGAGTCGGTGG -> GAGTCGGTGGG
AGAGTGTCAGA -> GAGTGTCAGAA
AGATACCTAGC -> GATACCTAGCG
AGATACGATTC -> GATACGATTCC
AGATACGTCCC -> GATACGTCCCA
AGATCGCACAT -> GATCGCACATT
AGATCTAGGAC -> GATCTAGGACG
AGATCTTATAC -> GATCTTATACC
AGATGTCGGAG -> GATGTCGGAGG
AGCACGGTGGC -> GCACGGTGGCA
AGCACTCCCAG -> GCACTCCCAGA
AGCACTCGGAA -> GCACTCGGAAC
AGCACTGTCCA -> GCACTGTCCAT
AGCCCACTCAG -> GCCCACTCAGC
AGCCCCCAGGT -> GCCCCCAGGTC
AGCCCTTCGCC -> GCCCTTCGCCG
AGCCGAACGAA -> GCCGAACGAAG
AGCCGACGCAT -> GCCGACGCATT
AGCCGCAACTA -> GCCGCAACTAC
AGCCGGTACAA -> GCCGGTACAAG
AGCCGTCTTTA -> GCCGTCTTTAA
AGCCTTCTGGC -> GCCTTCTGGCG
AGCGATCTTCA -> GCGATCTTCAG
AGCGGGCACGG -> GCGGGCACGGT
AGCGGGGCCAT -> GCGGGGCCATC
AGCGGGTTGAC -> GCGGGTTGACA
AGCGGTTCCTT -> GCGGTTCCTTT
AGCGTCAGGTT -> GCGTCAGGTTT
AGCTACGGACT -> GCTACGGACTA
AGCTACTGTAA -> GCTACTGTAAT
AGCTCCTGGAT -> GCTCCTGGATC
AGCTCGATCGA -> GCTCGATCGAA
AGCTCTGAAGC -> GCTCTGAAGCA
AGCTCTTCTAT -> GCTCTTCTATT
AGCTGGTCCCC -> GCTGGTCCCCC
AGCTTAGACCA -> GCTTAGACCAA
AGCTTGCAGAT -> GCTTGCAGATA
AGCTTTCTTCG -> GCTTTCTTCGG
AGGAAGGATAA -> GGAAGGATAAT
AGGACACATGC -> GGACACATGCT
AGGACGAGTAT -> GGACGAGTATC
AGGAGGCGAAC -> GGAGGCGAACA
AGGAGTTTTAT -> GGAGTTTTATG
AGGATAATGTA -> GGATAATGTAA
AGGATCTTACG -> GGATCTTACGA
AGGCACGATCC -> GGCACGATCCG
AGGCACTACGT -> GGCACTACGTT
AGGCCACGCTA -> GGCCACGCTAC
AGGCCTCGGTT -> GGCCTCGGTTT
AGGCGAACAAC -> GGCGAACAACG
AGGCGTTATTT -> GGCGTTATTTG
AGGGAAAAACT -> GGGAAAAACTA
AGGGAGCCGAA -> GGGAGCCGAAC
AGGGCCCGACT -> GGGCCCGACTG
AGGGCCCTGGT -> GGGCCCTGGTA
AGGGCCGTGCG -> GGGCCGTGCGG
AGGGCGCGACA -> GGGCGCGACAG
AGGGCGTCTTT -> GGGCGTCTTTT
AGGGCTCACCA -> GGGCTCACCAC
AGGGGTAGAAG -> GGGGTAGAAGT
AGGTAACTTGC -> GGTAACTTGCA
AGGTATCCCTC -> GGTATCCCTCT
AGGTCCGAACC -> GGTCCGAACCA
AGGTCCTCTCT -> GGTCCTCTCTA
AGGTCGCAATA -> GGTCGCAATAT
AGGTCTACCAT -> GGTCTACCATA
AGGTGCAGGAG -> GGTGCAGGAGT
AGGTGCCTATT -> GGTGCCTATTG
AGGTGGAAACC -> GGTGGAAACCC
AGGTGGGGCCG -> GGTGGGGCCGC
AGGTTATGAGC -> GGTTATGAGCA
AGGTTGAACCG -> GGTTGAACCGC
AGGTTGACACT -> GGTTGACACTA
AGGTTGGTAAC -> GGTTGGTAACA
AGGTTTCCCAG -> GGTTTCCCAGT
AGGTTTCCGGA -> GGTTTCCGGAG
AGGTTTCTACC -> GGTTTCTACCT
AGTACCTCCCC -> GTACCTCCCCC
AGTACTGACAG -> GTACTGACAGT
AGTAGGGGTAG -> GTAGGGGTAGA
AGTAGGTGGGG -> GTAGGTGGGGC
AGTAGGTTGGT -> GTAGGTTGGTA
AGTATCCCCAG -> GTATCCCCAGA
AGTCAGCCCCC -> GTCAGCCCCCA
AGTCATGGTCT -> GTCATGGTCTA
AGTCCACTGAT -> GTCCACTGATG
AGTCCTTTCGA -> GTCCTTTCGAA
AGTCGGTGGGG -> GTCGGTGGGGC
AGTCTCCTAGA -> GTCTCCTAGAA
AGTCTCGGTCT -> GTCTCGGTCTT
AGTCTGAGCTA -> GTCTGAGCTAC
AGTGCTTCGGG -> GTGCTTCGGGC
AGTGGTCCTGT -> GTGGTCCTGTG
AGTGTCAGAAT -> GTGTCAGAATC
AGTGTTTGGGA -> GTGTTTGGGAG
AGTTAAGAAGA -> GTTAAGAAGAG
AGTTAATCCGC -> GTTAATCCGCG
AGTTACCGGTC -> GTTACCGGTCA
AGTTACGCTGC -> GTTACGCTGCA
AGTTAGATACC -> GTTAGATACCT
AGTTCAAACCT -> GTTCAAACCTG
AGTTCTACGTG -> GTTCTACGTGG
AGTTGGATTGG -> GTTGGATTGGT
AGTTGTATTGG -> GTTGTATTGGC
AGTTTTATGTG -> GTTTTATGTGA
ATAAACGGAAA -> TAAACGGAAAT
ATAAATGAGGG -> TAAATGAGGGA
ATAACGCTCTC -> TAACGCTCTCA
ATAAGCCGCAA -> TAAGCCGCAAC
ATAATGTAAAT -> TAATGTAAATT
ATACATTCGAA -> TACATTCGAAG
ATACCCGTGAG -> TACCCGTGAGC
ATACCTAGCGA -> TACCTAGCGAT
ATACCTGACCG -> TACCTGACCGC
ATACCTTCATA -> TACCTTCATAC
ATACGATTCCT -> TACGATTCCTG
ATACGTCCCAT -> TACGTCCCATT
ATACTGGATCT -> TACTGGATCTC
ATAGCCCTTCG -> TAGCCCTTCGC
ATAGTTACCGG -> TAGTTACCGGT
ATAGTTACGCT -> TAGTTACGCTG
ATATCACAGTT -> TATCACAGTTG
ATATCGAGGTG -> TATCGAGGTGG
ATATGATCCAT -> TATGATCCATC
ATATGCGTGAG -> TATGCGTGAGC
ATATGTAGTGT -> TATGTAGTGTT
ATCAAACAATC -> TCAAACAATCC
ATCAAGAACGC -> TCAAGAACGCG
ATCAAGGTCCG -> TCAAGGTCCGA
ATCACAGTTGT -> TCACAGTTGTA
ATCACCCAGGT -> TCACCCAGGTA
ATCATCAAACA -> TCATCAAACAA
ATCCATCCCCT -> TCCATCCCCTT
ATCCCAGCACT -> TCCCAGCACTG
ATCCCCAATCT -> TCCCCAATCTA
ATCCCCAGAGT -> TCCCCAGAGTA
ATCCCCTTGTT -> TCCCCTTGTTA
ATCCCTCTAAC -> TCCCTCTAACG
ATCCGAACAAC -> TCCGAACAACT
ATCCGAGTCTG -> TCCGAGTCTGA
ATCCGCGGCTC -> TCCGCGGCTCT
ATCCGGGTAAT -> TCCGGGTAATC
ATCCTACGCCC -> TCCTACGCCCC
ATCCTCTATCG -> TCCTCTATCGA
ATCCTTATATG -> TCCTTATATGT
ATCGAACTAAC -> TCGAACTAACT
ATCGAACTAGT -> TCGAACTAGTT
ATCGAGGTGGA -> TCGAGGTGGAA
ATCGATGATCC -> TCGATGATCCG
ATCGCACATTG -> TCGCACATTGC
ATCGGGGTTAA -> TCGGGGTTAAG
ATCGTATGTGA -> TCGTATGTGAA
ATCGTGGGCTG -> TCGTGGGCTGA
ATCGTGTGGGA -> TCGTGTGGGAC
ATCGTTAGTCT -> TCGTTAGTCTC
ATCTAGACCAC -> TCTAGACCACA
ATCTAGGACGA -> TCTAGGACGAG
ATCTCACGCTA -> TCTCACGCTAA
ATCTCATGCAC -> TCTCATGCACA
ATCTCGCATCC -> TCTCGCATCCC
ATCTCGTAAAA -> TCTCGTAAAAG
ATCTTACGAAT -> TCTTACGAATT
ATCTTATACCT -> TCTTATACCTT
ATCTTCAGAGA -> TCTTCAGAGAG
ATCTTCCGATT -> TCTTCCGATTC
ATCTTGTAAGG -> TCTTGTAAGGA
ATCTTGTGCGC -> TCTTGTGCGCA
ATGAAATGGCA -> TGAAATGGCAT
ATGAAGATACG -> TGAAGATACGT
ATGACCAGGCC -> TGACCAGGCCT
ATGAGCACGGT -> TGAGCACGGTG
ATGAGGGAGCC -> TGAGGGAGCCG
ATGATCCATCC -> TGATCCATCCC
ATGATCCGGGT -> TGATCCGGGTA
ATGCACAAATC -> TGCACAAATCC
ATGCGTGAGCG -> TGCGTGAGCGG
ATGCTCCCGAG -> TGCTCCCGAGT
ATGCTGTCGTT -> TGCTGTCGTTA
ATGGATGGCAC -> TGGATGGCACA
ATGGCACATTA -> TGGCACATTAG
ATGGCATCAAG -> TGGCATCAAGA
ATGGCGCGCCA -> TGGCGCGCCAA
ATGGGAAGTTG -> TGGGAAGTTGG
ATGGTCTAGGG -> TGGTCTAGGGC
ATGTAAACAGC -> TGTAAACAGCC
ATGTAAATTCA -> TGTAAATTCAT
ATGTAGGCGTT -> TGTAGGCGTTA
ATGTAGTGTTT -> TGTAGTGTTTG
ATGTCCGGGTG -> TGTCCGGGTGT
ATGTCGGAGGG -> TGTCGGAGGGC
ATGTGAAGTGG -> TGTGAAGTGGT
ATGTGACTTTT -> TGTGACTTTTT
ATTACGTTTGA -> TTACGTTTGAA
ATTAGACCGCA -> TTAGACCGCAA
ATTAGCCGTCT -> TTAGCCGTCTT
ATTCATACTGG -> TTCATACTGGA
ATTCATGGGAA -> TTCATGGGAAG
ATTCCTGCTGA -> TTCCTGCTGAG
ATTCGAAGGTT -> TTCGAAGGTTA
ATTCGATCGTG -> TTCGATCGTGG
ATTCGGAATAG -> TTCGGAATAGT
ATTCGTTGTTA -> TTCGTTGTTAA
ATTCTATATGC -> TTCTATATGCG
ATTCTCGGCGA -> TTCTCGGCGAT
ATTCTTGTAAT -> TTCTTGTAATT
ATTGAGTCAGC -> TTGAGTCAGCC
ATTGCATAGCC -> TTGCATAGCCC
ATTGCTCCGAA -> TTGCTCCGAAC
ATTGGCCACGC -> TTGGCCACGCC
ATTGGTGGTCA -> TTGGTGGTCAT
ATTGTCATCCT -> TTGTCATCCTA
ATTGTCTGCAC -> TTGTCTGCACA
ATTTACGCCAG -> TTTACGCCAGT
ATTTCACTCTT -> TTTCACTCTTG
ATTTCCGCACA -> TTTCCGCACAA
ATTTGCCGCGC -> TTTGCCGCGCT
ATTTGCGGCAA -> TTTGCGGCAAT
CAAAAAGCCGA -> AAAAAGCCGAC
CAAACAATCCT -> AAACAATCCTT
CAAACACAGAC -> AAACACAGACT
CAAACCTGTAA -> AAACCTGTAAT
CAAACGACTTG -> AAACGACTTGT
CAAACTCAGGT -> AAACTCAGGTT
CAAATCCGAGT -> AAATCCGAGTC
CAAATCTCATG -> AAATCTCATGC
CAACCTAACCT -> AACCTAACCTA
CAACGCGACAG -> AACGCGACAGG
CAACTACCTAC -> AACTACCTACT
CAACTGTTTGA -> AACTGTTTGAT
CAACTTATTCG -> AACTTATTCGA
CAAGAACGCGA -> AAGAACGCGAC
CAAGAGCGGGG -> AAGAGCGGGGC
CAAGGTAACTT -> AAGGTAACTTG
CAAGGTCCGAA -> AAGGTCCGAAC
CAATATCGAGG -> AATATCGAGGT
CAATCCTTATA -> AATCCTTATAT
CAATCTAGACC -> AATCTAGACCA
CAATGAAGATA -> AATGAAGATAC
CACAAATCCGA -> ACAAATCCGAG
CACAAATCTCA -> ACAAATCTCAT
CACACGATAAA -> ACACGATAAAT
CACAGACTGAT -> ACAGACTGATT
CACAGCTCGAT -> ACAGCTCGATC
CACAGGTCGCA -> ACAGGTCGCAA
CACAGTTGTAT -> ACAGTTGTATT
CACATGCTGTC -> ACATGCTGTCG
CACATTAGACC -> ACATTAGACCG
CACATTGCTCC -> ACATTGCTCCG
CACCACCACTG -> ACCACCACTGA
CACCACTGATG -> ACCACTGATGT
CACCCAGGTAT -> ACCCAGGTATC
CACGATAAATG -> ACGATAAATGA
CACGATCCGAA -> ACGATCCGAAC
CACGCCGCGCC -> ACGCCGCGCCT
CACGCTAAGCT -> ACGCTAAGCTG
CACGCTACGGG -> ACGCTACGGGT
CACGGCGGAAG -> ACGGCGGAAGG
CACGGGCATAA -> ACGGGCATAAC
CACGGTCGCCA -> ACGGTCGCCAG
CACGGTCTGGT -> ACGGTCTGGTT
CACGGTGGCAT -> ACGGTGGCATC
CACTAAGAAAG -> ACTAAGAAAGG
CACTACGTTCG -> ACTACGTTCGG
CACTCAGCTCC -> ACTCAGCTCCT
CACTCCCAGAA -> ACTCCCAGAAA
CACTCGGAACA -> ACTCGGAACAG
CACTCTTGCGG -> ACTCTTGCGGG
CACTGATGCTC -> ACTGATGCTCC
CACTGATGTAA -> ACTGATGTAAA
CACTGTCCATT -> ACTGTCCATTA
CAGAAAACTCG -> AGAAAACTCGT
CAGAAAGATCT -> AGAAAGATCTT
CAGAATCTCAC -> AGAATCTCACG
CAGACGGCTGG -> AGACGGCTGGA
CAGACTGATTG -> AGACTGATTGA
CAGAGAGCTTT -> AGAGAGCTTTC
CAGAGTACTGA -> AGAGTACTGAC
CAGAGTCGGTG -> AGAGTCGGTGG
CAGATACGATT -> AGATACGATTC
CAGATCTAGGA -> AGATCTAGGAC
CAGCACTGTCC -> AGCACTGTCCA
CAGCCCACTCA -> AGCCCACTCAG
CAGCCCCCAGG -> AGCCCCCAGGT
CAGCCGGTACA -> AGCCGGTACAA
CAGCGGGTTGA -> AGCGGGTTGAC
CAGCGTCAGGT -> AGCGTCAGGTT
CAGCTCCTGGA -> AGCTCCTGGAT
CAGCTCGATCG -> AGCTCGATCGA
CAGCTCTTCTA -> AGCTCTTCTAT
CAGGAGTTTTA -> AGGAGTTTTAT
CAGGCACTACG -> AGGCACTACGT
CAGGCCACGCT -> AGGCCACGCTA
CAGGCCTCGGT -> AGGCCTCGGTT
CAGGGCCCTGG -> AGGGCCCTGGT
CAGGGCGCGAC -> AGGGCGCGACA
CAGGTATCCCT -> AGGTATCCCTC
CAGGTCGCAAT -> AGGTCGCAATA
CAGGTCTACCA -> AGGTCTACCAT
CAGGTGCCTAT -> AGGTGCCTATT
CAGGTTGACAC -> AGGTTGACACT
CAGGTTTCCCA -> AGGTTTCCCAG
CAGGTTTCCGG -> AGGTTTCCGGA
CAGGTTTCTAC -> AGGTTTCTACC
CAGTAGGGGTA -> AGTAGGGGTAG
CAGTAGGTGGG -> AGTAGGTGGGG
CAGTTAAGAAG -> AGTTAAGAAGA
CAGTTAATCCG -> AGTTAATCCGC
CAGTTCTACGT -> AGTTCTACGTG
CAGTTGTATTG -> AGTTGTATTGG
CATAACGCTCT -> ATAACGCTCTC
CATAAGCCGCA -> ATAAGCCGCAA
CATACCTGACC -> ATACCTGACCG
CATACTGGATC -> ATACTGGATCT
CATAGCCCTTC -> ATAGCCCTTCG
CATAGTTACCG -> ATAGTTACCGG
CATATGATCCA -> ATATGATCCAT
CATCAAACAAT -> ATCAAACAATC
CATCAAGAACG -> ATCAAGAACGC
CATCAAGGTCC -> ATCAAGGTCCG
CATCCCCAATC -> ATCCCCAATCT
CATCCCCTTGT -> ATCCCCTTGTT
CATCCTACGCC -> ATCCTACGCCC
CATCCTCTATC -> ATCCTCTATCG
CATCGAACTAG -> ATCGAACTAGT
CATCGTATGTG -> ATCGTATGTGA
CATCGTGTGGG -> ATCGTGTGGGA
CATCGTTAGTC -> ATCGTTAGTCT
CATCTTGTGCG -> ATCTTGTGCGC
CATGAAATGGC -> ATGAAATGGCA
CATGCACAAAT -> ATGCACAAATC
CATGCTGTCGT -> ATGCTGTCGTT
CATGGATGGCA -> ATGGATGGCAC
CATGGGAAGTT -> ATGGGAAGTTG
CATGGTCTAGG -> ATGGTCTAGGG
CATTACGTTTG -> ATTACGTTTGA
CATTAGACCGC -> ATTAGACCGCA
CATTCATACTG -> ATTCATACTGG
CATTCGAAGGT -> ATTCGAAGGTT
CATTCGTTGTT -> ATTCGTTGTTA
CATTCTCGGCG -> ATTCTCGGCGA
CATTGCTCCGA -> ATTGCTCCGAA
CATTGTCTGCA -> ATTGTCTGCAC
CATTTGCGGCA -> ATTTGCGGCAA
CCAAAAAGCCG -> CAAAAAGCCGA
CCAAACTCAGG -> CAAACTCAGGT
CCAATCTAGAC -> CAATCTAGACC
CCACAGCTCGA -> CACAGCTCGAT
CCACCACTGAT -> CACCACTGATG
CCACGCCGCGC -> CACGCCGCGCC
CCACGCTACGG -> CACGCTACGGG
CCACTCAGCTC -> CACTCAGCTCC
CCACTGATGCT -> CACTGATGCTC
CCACTGATGTA -> CACTGATGTAA
CCAGAAAACTC -> CAGAAAACTCG
CCAGAGTACTG -> CAGAGTACTGA
CCAGAGTCGGT -> CAGAGTCGGTG
CCAGATCTAGG -> CAGATCTAGGA
CCAGCACTGTC -> CAGCACTGTCC
CCAGCGTCAGG -> CAGCGTCAGGT
CCAGGCCTCGG -> CAGGCCTCGGT
CCAGGTATCCC -> CAGGTATCCCT
CCAGGTCTACC -> CAGGTCTACCA
CCAGGTGCCTA -> CAGGTGCCTAT
CCAGTTAAGAA -> CAGTTAAGAAG
CCAGTTCTACG -> CAGTTCTACGT
CCATAGTTACC -> CATAGTTACCG
CCATCCCCTTG -> CATCCCCTTGT
CCATCGAACTA -> CATCGAACTAG
CCATCGTATGT -> CATCGTATGTG
CCATCGTTAGT -> CATCGTTAGTC
CCATGGATGGC -> CATGGATGGCA
CCATTACGTTT -> CATTACGTTTG
CCATTCATACT -> CATTCATACTG
CCATTCGTTGT -> CATTCGTTGTT
CCCAATCTAGA -> CCAATCTAGAC
CCCACTCAGCT -> CCACTCAGCTC
CCCAGAAAACT -> CCAGAAAACTC
CCCAGAGTACT -> CCAGAGTACTG
CCCAGCACTGT -> CCAGCACTGTC
CCCAGCGTCAG -> CCAGCGTCAGG
CCCAGGTATCC -> CCAGGTATCCC
CCCAGGTCTAC -> CCAGGTCTACC
CCCAGTTAAGA -> CCAGTTAAGAA
CCCATTCATAC -> CCATTCATACT
CCCATTCGTTG -> CCATTCGTTGT
CCCCAATCTAG -> CCCAATCTAGA
CCCCAGAGTAC -> CCCAGAGTACT
CCCCAGCGTCA -> CCCAGCGTCAG
CCCCAGGTCTA -> CCCAGGTCTAC
CCCCCAGGTCT -> CCCCAGGTCTA
CCCCCGGTGCA -> CCCCGGTGCAC
CCCCCTAACGG -> CCCCTAACGGC
CCCCCTAGACG -> CCCCTAGACGA
CCCCGGTGCAC -> CCCGGTGCACA
CCCCTAACGGC -> CCCTAACGGCT
CCCCTAGACGA -> CCCTAGACGAA
CCCCTTAGGTT -> CCCTTAGGTTG
CCCCTTGTTAC -> CCCTTGTTACA
CCCGACTGAAC -> CCGACTGAACG
CCCGAGTTAGA -> CCGAGTTAGAT
CCCGATGACCA -> CCGATGACCAG
CCCGGACGAGG -> CCGGACGAGGG
CCCGGTGCACA -> CCGGTGCACAG
CCCGTGAGCGG -> CCGTGAGCGGT
CCCTAACGGCT -> CCTAACGGCTC
CCCTAGACGAA -> CCTAGACGAAA
CCCTCTAACGT -> CCTCTAACGTA
CCCTGGTAAAT -> CCTGGTAAATT
CCCTTAGGTTG -> CCTTAGGTTGA
CCCTTCGCCGC -> CCTTCGCCGCA
CCCTTGTTACA -> CCTTGTTACAC
CCGAACAACTG -> CGAACAACTGT
CCGAACAGGTT -> CGAACAGGTTT
CCGAACCATCG -> CGAACCATCGT
CCGAACGAAGG -> CGAACGAAGGA
CCGAAGTACCT -> CGAAGTACCTC
CCGACGCATTT -> CGACGCATTTG
CCGACTGAACG -> CGACTGAACGG
CCGAGTCTGAG -> CGAGTCTGAGC
CCGAGTTAGAT -> CGAGTTAGATA
CCGATGACCAG -> CGATGACCAGG
CCGATTCGGAA -> CGATTCGGAAT
CCGCAAACGAC -> CGCAAACGACT
CCGCAACCTAA -> CGCAACCTAAC
CCGCAACTACC -> CGCAACTACCT
CCGCACAAATC -> CGCACAAATCT
CCGCCATGGAT -> CGCCATGGATG
CCGCCTCCCAT -> CGCCTCCCATT
CCGCGCCTGTC -> CGCGCCTGTCG
CCGCGCTAGCT -> CGCGCTAGCTA
CCGCGGCTCTT -> CGCGGCTCTTG
CCGCTCCGAAG -> CGCTCCGAAGT
CCGGACGAGGG -> CGGACGAGGGC
CCGGAGCCTTC -> CGGAGCCTTCT
CCGGGTAATCT -> CGGGTAATCTT
CCGGGTGTTCC -> CGGGTGTTCCA
CCGGTACAAGG -> CGGTACAAGGT
CCGGTCACGGT -> CGGTCACGGTC
CCGGTGCACAG -> CGGTGCACAGG
CCGTCTTTAAT -> CGTCTTTAATC
CCGTGAGCGGT -> CGTGAGCGGTT
CCGTGCGGTGA -> CGTGCGGTGAA
CCTAACCTATC -> CTAACCTATCG
CCTAACGGCTC -> CTAACGGCTCC
CCTACGCCCCA -> CTACGCCCCAG
CCTACTAATAA -> CTACTAATAAA
CCTAGAAGGCA -> CTAGAAGGCAC
CCTAGACGAAA -> CTAGACGAAAT
CCTAGCGATCT -> CTAGCGATCTT
CCTATCGGGGT -> CTATCGGGGTT
CCTATTGTCAT -> CTATTGTCATC
CCTCCCATTCG -> CTCCCATTCGT
CCTCCCCCTAA -> CTCCCCCTAAC
CCTCCCCCTAG -> CTCCCCCTAGA
CCTCGGTTTTA -> CTCGGTTTTAG
CCTCTAACGTA -> CTCTAACGTAC
CCTCTATCGAT -> CTCTATCGATG
CCTCTCCATCG -> CTCTCCATCGA
CCTCTCTAGAT -> CTCTCTAGATG
CCTGACCGCTC -> CTGACCGCTCC
CCTGCTGAGCA -> CTGCTGAGCAC
CCTGGATCATC -> CTGGATCATCA
CCTGGTAAATT -> CTGGTAAATTA
CCTGTAATCTC -> CTGTAATCTCG
CCTGTCGGCGA -> CTGTCGGCGAC
CCTGTGGACCT -> CTGTGGACCTC
CCTTAGGTTGA -> CTTAGGTTGAA
CCTTATATGTA -> CTTATATGTAG
CCTTCATACCT -> CTTCATACCTG
CCTTCGCCGCA -> CTTCGCCGCAA
CCTTCTGGCGC -> CTTCTGGCGCA
CCTTGTTACAC -> CTTGTTACACG
CCTTTCATCCT -> CTTTCATCCTC
CCTTTCGAAGT -> CTTTCGAAGTA
CCTTTCTTTAT -> CTTTCTTTATC
CGAAATTCTTG -> GAAATTCTTGT
CGAACAACGCG -> GAACAACGCGA
CGAACAACTGT -> GAACAACTGTT
CGAACAGGTTT -> GAACAGGTTTC
CGAACCATCGT -> GAACCATCGTA
CGAACGAAGGA -> GAACGAAGGAG
CGAACTAACTT -> GAACTAACTTC
CGAACTAGTTT -> GAACTAGTTTA
CGAAGGAGGCG -> GAAGGAGGCGA
CGAAGGTTATG -> GAAGGTTATGA
CGAAGTACCTC -> GAAGTACCTCC
CGAAGTAGGTT -> GAAGTAGGTTG
CGAATTTCCGC -> GAATTTCCGCA
CGACACGGGCA -> GACACGGGCAT
CGACAGAAAGA -> GACAGAAAGAT
CGACAGGTTTC -> GACAGGTTTCC
CGACATTCTCG -> GACATTCTCGG
CGACGCATTTG -> GACGCATTTGC
CGACTGAACGG -> GACTGAACGGG
CGACTTGTGCA -> GACTTGTGCAG
CGAGGGCTCAC -> GAGGGCTCACC
CGAGGTGGAAA -> GAGGTGGAAAC
CGAGTATCCCC -> GAGTATCCCCA
CGAGTCTGAGC -> GAGTCTGAGCT
CGAGTTAGATA -> GAGTTAGATAC
CGATAAATGAG -> GATAAATGAGG
CGATCCGAACA -> GATCCGAACAA
CGATCGAACTA -> GATCGAACTAA
CGATCGTGGGC -> GATCGTGGGCT
CGATCTTCAGA -> GATCTTCAGAG
CGATGACCAGG -> GATGACCAGGC
CGATGATCCGG -> GATGATCCGGG
CGATGTCCGGG -> GATGTCCGGGT
CGATTCCTGCT -> GATTCCTGCTG
CGATTCGGAAT -> GATTCGGAATA
CGCAAACGACT -> GCAAACGACTT
CGCAACCTAAC -> GCAACCTAACC
CGCAACTACCT -> GCAACTACCTA
CGCAACTTATT -> GCAACTTATTC
CGCAAGAGCGG -> GCAAGAGCGGG
CGCAATATCGA -> GCAATATCGAG
CGCACAAATCT -> GCACAAATCTC
CGCACATTGCT -> GCACATTGCTC
CGCATCCCCAA -> GCATCCCCAAT
CGCATGAAATG -> GCATGAAATGG
CGCATTTGCGG -> GCATTTGCGGC
CGCCAAACTCA -> GCCAAACTCAG
CGCCAGAGTCG -> GCCAGAGTCGG
CGCCAGTTCTA -> GCCAGTTCTAC
CGCCATGGATG -> GCCATGGATGG
CGCCCCAGCGT -> GCCCCAGCGTC
CGCCGCAAACG -> GCCGCAAACGA
CGCCGCGCCTG -> GCCGCGCCTGT
CGCCTCCCATT -> GCCTCCCATTC
CGCCTGTCGGC -> GCCTGTCGGCG
CGCGACAGAAA -> GCGACAGAAAG
CGCGACAGGTT -> GCGACAGGTTT
CGCGACATTCT -> GCGACATTCTC
CGCGCCAAACT -> GCGCCAAACTC
CGCGCCTGTCG -> GCGCCTGTCGG
CGCGCTAGCTA -> GCGCTAGCTAC
CGCGGAGATCG -> GCGGAGATCGC
CGCGGCTCTTG -> GCGGCTCTTGT
CGCTAAGCTGG -> GCTAAGCTGGT
CGCTACGGGTA -> GCTACGGGTAG
CGCTAGCTACG -> GCTAGCTACGG
CGCTCAGGCAC -> GCTCAGGCACT
CGCTCCGAAGT -> GCTCCGAAGTA
CGCTCTCAGGC -> GCTCTCAGGCC
CGCTGCAGGGC -> GCTGCAGGGCG
CGGAAATGGCG -> GGAAATGGCGC
CGGAACAGCCC -> GGAACAGCCCA
CGGAAGGTGCA -> GGAAGGTGCAG
CGGAATAGTTA -> GGAATAGTTAC
CGGACGAGGGC -> GGACGAGGGCT
CGGACTACGCG -> GGACTACGCGG
CGGAGATCGCA -> GGAGATCGCAC
CGGAGCCTTCT -> GGAGCCTTCTG
CGGAGGGCGTC -> GGAGGGCGTCT
CGGATACATTC -> GGATACATTCG
CGGCAATGAAG -> GGCAATGAAGA
CGGCGACACGG -> GGCGACACGGG
CGGCGATGTCC -> GGCGATGTCCG
CGGCGGAAGGT -> GGCGGAAGGTG
CGGCTATACCC -> GGCTATACCCG
CGGCTCCCGGA -> GGCTCCCGGAC
CGGCTCTTGTA -> GGCTCTTGTAC
CGGCTGGAGAG -> GGCTGGAGAGT
CGGGAAGCTTA -> GGGAAGCTTAG
CGGGACAGGGC -> GGGACAGGGCC
CGGGACGGTTG -> GGGACGGTTGC
CGGGCACGGTC -> GGGCACGGTCT
CGGGCATAACG -> GGGCATAACGC
CGGGCGCATGA -> GGGCGCATGAA
CGGGGCCATCG -> GGGGCCATCGT
CGGGGTTAAGT -> GGGGTTAAGTC
CGGGTAATCTT -> GGGTAATCTTC
CGGGTAGTCCT -> GGGTAGTCCTT
CGGGTGTTCCA -> GGGTGTTCCAG
CGGGTTGACAT -> GGGTTGACATC
CGGTACAAGGT -> GGTACAAGGTA
CGGTCACGGTC -> GGTCACGGTCG
CGGTCGCCAGA -> GGTCGCCAGAG
CGGTCTGGTTT -> GGTCTGGTTTG
CGGTCTTACAG -> GGTCTTACAGT
CGGTGAAGCTT -> GGTGAAGCTTG
CGGTGCACAGG -> GGTGCACAGGT
CGGTGGCATCA -> GGTGGCATCAA
CGGTGGGGCAG -> GGTGGGGCAGC
CGGTTCCTTTC -> GGTTCCTTTCA
CGGTTGCCAGG -> GGTTGCCAGGT
CGGTTTTAGTC -> GGTTTTAGTCA
CGTAAAAGCTC -> GTAAAAGCTCT
CGTACATTGTC -> GTACATTGTCT
CGTACCTCCCC -> GTACCTCCCCC
CGTATGTGAAG -> GTATGTGAAGT
CGTCAGGTTTC -> GTCAGGTTTCT
CGTCCCATTCA -> GTCCCATTCAT
CGTCTTTAATC -> GTCTTTAATCA
CGTCTTTTTTG -> GTCTTTTTTGA
CGTGAGCGGGC -> GTGAGCGGGCA
CGTGAGCGGTT -> GTGAGCGGTTC
CGTGCGGTGAA -> GTGCGGTGAAG
CGTGGCCCGAT -> GTGGCCCGATG
CGTGGGCTGAG -> GTGGGCTGAGG
CGTGTGGGACG -> GTGTGGGACGC
CGTTAGTCTCC -> GTTAGTCTCCT
CGTTAGTGCTT -> GTTAGTGCTTC
CGTTATTTGCC -> GTTATTTGCCG
CGTTCGGCTAT -> GTTCGGCTATA
CGTTGTTAATT -> GTTGTTAATTC
CGTTTGAAACA -> GTTTGAAACAT
CTAACCTATCG -> TAACCTATCGG
CTAACGGCTCC -> TAACGGCTCCC
CTAACGTACAT -> TAACGTACATT
CTAACTTCGGG -> TAACTTCGGGA
CTAAGAAAGGG -> TAAGAAAGGGA
CTAAGCTGGTC -> TAAGCTGGTCC
CTAATAAACGG -> TAATAAACGGA
CTACCATAGTT -> TACCATAGTTA
CTACCTACTAA -> TACCTACTAAT
CTACCTTTCTT -> TACCTTTCTTT
CTACGCCCCAG -> TACGCCCCAGC
CTACGCGGAGA -> TACGCGGAGAT
CTACGGACTAC -> TACGGACTACG
CTACGGGTAGT -> TACGGGTAGTC
CTACGTGGCCC -> TACGTGGCCCG
CTACGTTCGGC -> TACGTTCGGCT
CTACTAATAAA -> TACTAATAAAC
CTACTGTAATT -> TACTGTAATTT
CTAGAAGGCAC -> TAGAAGGCACG
CTAGACCACAG -> TAGACCACAGC
CTAGACGAAAT -> TAGACGAAATT
CTAGATGTCGG -> TAGATGTCGGA
CTAGCGATCTT -> TAGCGATCTTC
CTAGCTACGGA -> TAGCTACGGAC
CTAGGACGAGT -> TAGGACGAGTA
CTAGGGCCCGA -> TAGGGCCCGAC
CTAGTTTAGCG -> TAGTTTAGCGG
CTATACCCGTG -> TATACCCGTGA
CTATATGCGTG -> TATATGCGTGA
CTATCGATGAT -> TATCGATGATC
CTATCGGGGTT -> TATCGGGGTTA
CTATCTTGTAA -> TATCTTGTAAG
CTATTGCATAG -> TATTGCATAGC
CTATTGTCATC -> TATTGTCATCC
CTCACCACCAC -> TCACCACCACT
CTCACGCTAAG -> TCACGCTAAGC
CTCAGCTCCTG -> TCAGCTCCTGG
CTCAGGCACTA -> TCAGGCACTAC
CTCAGGCCACG -> TCAGGCCACGC
CTCAGGTTGAC -> TCAGGTTGACA
CTCATGCACAA -> TCATGCACAAA
CTCCATCGAAC -> TCCATCGAACT
CTCCCAGAAAA -> TCCCAGAAAAC
CTCCCATTCGT -> TCCCATTCGTT
CTCCCCCTAAC -> TCCCCCTAACG
CTCCCCCTAGA -> TCCCCCTAGAC
CTCCCGAGTTA -> TCCCGAGTTAG
CTCCCGGACGA -> TCCCGGACGAG
CTCCGAACAGG -> TCCGAACAGGT
CTCCGAAGTAC -> TCCGAAGTACC
CTCCTAGAAGG -> TCCTAGAAGGC
CTCCTGGATCA -> TCCTGGATCAT
CTCGATCGAAC -> TCGATCGAACT
CTCGCATCCCC -> TCGCATCCCCA
CTCGGAACAGC -> TCGGAACAGCC
CTCGGCGATGT -> TCGGCGATGTC
CTCGGTCTTAC -> TCGGTCTTACA
CTCGGTTTTAG -> TCGGTTTTAGT
CTCGTAAAAGC -> TCGTAAAAGCT
CTCGTACCTCC -> TCGTACCTCCC
CTCTAACGTAC -> TCTAACGTACA
CTCTAGATGTC -> TCTAGATGTCG
CTCTATCGATG -> TCTATCGATGA
CTCTCAGGCCA -> TCTCAGGCCAC
CTCTCCATCGA -> TCTCCATCGAA
CTCTCTAGATG -> TCTCTAGATGT
CTCTGAAGCAC -> TCTGAAGCACT
CTCTTCTATTG -> TCTTCTATTGC
CTCTTGCGGGA -> TCTTGCGGGAA
CTCTTGTACAG -> TCTTGTACAGA
CTGAACGGGAC -> TGAACGGGACG
CTGAAGCACTC -> TGAAGCACTCG
CTGACAGTAGG -> TGACAGTAGGT
CTGACCGCTCC -> TGACCGCTCCG
CTGAGCACTCC -> TGAGCACTCCC
CTGAGCTACTG -> TGAGCTACTGT
CTGAGGACACA -> TGAGGACACAT
CTGATGCTCCC -> TGATGCTCCCG
CTGATGTAAAC -> TGATGTAAACA
CTGATTGAGTC -> TGATTGAGTCA
CTGCACACGAT -> TGCACACGATA
CTGCAGGGCGC -> TGCAGGGCGCG
CTGCTGAGCAC -> TGCTGAGCACT
CTGGAGAGTGT -> TGGAGAGTGTC
CTGGATCATCA -> TGGATCATCAA
CTGGATCTCGC -> TGGATCTCGCA
CTGGCGCAACT -> TGGCGCAACTT
CTGGTAAATTA -> TGGTAAATTAG
CTGGTCCCCCG -> TGGTCCCCCGG
CTGGTTTGAAG -> TGGTTTGAAGT
CTGTAATCTCG -> TGTAATCTCGT
CTGTAATTTCA -> TGTAATTTCAC
CTGTCCATTAC -> TGTCCATTACG
CTGTCGGCGAC -> TGTCGGCGACA
CTGTCGTTAGT -> TGTCGTTAGTG
CTGTGGACCTC -> TGTGGACCTCT
CTGTTTGATAT -> TGTTTGATATC
CTTACAGTTAA -> TTACAGTTAAT
CTTACGAATTT -> TTACGAATTTC
CTTAGACCAAA -> TTAGACCAAAA
CTTAGGTTGAA -> TTAGGTTGAAC
CTTATACCTTC -> TTATACCTTCA
CTTATATGTAG -> TTATATGTAGT
CTTATTCGATC -> TTATTCGATCG
CTTCAGAGAGC -> TTCAGAGAGCT
CTTCATACCTG -> TTCATACCTGA
CTTCCGATTCG -> TTCCGATTCGG
CTTCGCCGCAA -> TTCGCCGCAAA
CTTCGGATACA -> TTCGGATACAT
CTTCGGGACAG -> TTCGGGACAGG
CTTCGGGCGCA -> TTCGGGCGCAT
CTTCTATTGCA -> TTCTATTGCAT
CTTCTGGCGCA -> TTCTGGCGCAA
CTTGCAGATAC -> TTGCAGATACG
CTTGCATAAGC -> TTGCATAAGCC
CTTGCGGGAAG -> TTGCGGGAAGC
CTTGTAAGGAA -> TTGTAAGGAAG
CTTGTAATTTA -> TTGTAATTTAC
CTTGTACAGAC -> TTGTACAGACG
CTTGTGCAGCG -> TTGTGCAGCGG
CTTGTGCGCAA -> TTGTGCGCAAG
CTTGTTACACG -> TTGTTACACGG
CTTTAATCACC -> TTTAATCACCC
CTTTATCCCAG -> TTTATCCCAGC
CTTTCATCCTC -> TTTCATCCTCT
CTTTCGAAGTA -> TTTCGAAGTAG
CTTTCTTCGGA -> TTTCTTCGGAT
CTTTCTTTATC -> TTTCTTTATCC
CTTTTTACAGT -> TTTTTACAGTA
CTTTTTTGATG -> TTTTTTGATGT
GAAAAACTATC -> AAAAACTATCT
GAAAACTCGTA -> AAAACTCGTAC
GAAACATATGA -> AAACATATGAT
GAAACCCCTTA -> AAACCCCTTAG
GAAAGATCTTA -> AAAGATCTTAT
GAAAGGGAAAA -> AAAGGGAAAAA
GAAATGGCATC -> AAATGGCATCA
GAAATGGCGCG -> AAATGGCGCGC
GAAATTCTTGT -> AAATTCTTGTA
GAACAACGCGA -> AACAACGCGAC
GAACAACTGTT -> AACAACTGTTT
GAACAGCCCAC -> AACAGCCCACT
GAACAGGTTTC -> AACAGGTTTCC
GAACCATCGTA -> AACCATCGTAT
GAACCGCCATG -> AACCGCCATGG
GAACGAAGGAG -> AACGAAGGAGG
GAACGCGACAT -> AACGCGACATT
GAACGGGACGG -> AACGGGACGGT
GAACTAACTTC -> AACTAACTTCG
GAACTAGTTTA -> AACTAGTTTAG
GAAGAGGGCCG -> AAGAGGGCCGT
GAAGATACGTC -> AAGATACGTCC
GAAGCACTCGG -> AAGCACTCGGA
GAAGCTTAGAC -> AAGCTTAGACC
GAAGCTTGCAG -> AAGCTTGCAGA
GAAGGAGGCGA -> AAGGAGGCGAA
GAAGGATAATG -> AAGGATAATGT
GAAGGCACGAT -> AAGGCACGATC
GAAGGTGCAGG -> AAGGTGCAGGA
GAAGGTTATGA -> AAGGTTATGAG
GAAGTACCTCC -> AAGTACCTCCC
GAAGTAGGTTG -> AAGTAGGTTGG
GAAGTCTCGGT -> AAGTCTCGGTC
GAAGTGGTCCT -> AAGTGGTCCTG
GAAGTTCAAAC -> AAGTTCAAACC
GAAGTTGGATT -> AAGTTGGATTG
GAATAGTTACG -> AATAGTTACGC
GAATCTCACGC -> AATCTCACGCT
GAATTTCCGCA -> AATTTCCGCAC
GACACATGCTG -> ACACATGCTGT
GACACGGGCAT -> ACACGGGCATA
GACACTAAGAA -> ACACTAAGAAA
GACAGAAAGAT -> ACAGAAAGATC
GACAGGGCCCT -> ACAGGGCCCTG
GACAGGTTTCC -> ACAGGTTTCCC
GACAGTAGGTG -> ACAGTAGGTGG
GACATCGTGTG -> ACATCGTGTGG
GACATTCTCGG -> ACATTCTCGGC
GACCAAAAAGC -> ACCAAAAAGCC
GACCACAGCTC -> ACCACAGCTCG
GACCAGGCCTC -> ACCAGGCCTCG
GACCGCAACCT -> ACCGCAACCTA
GACCGCTCCGA -> ACCGCTCCGAA
GACCTCTCCAT -> ACCTCTCCATC
GACGAAATTCT -> ACGAAATTCTT
GACGAGGGCTC -> ACGAGGGCTCA
GACGAGTATCC -> ACGAGTATCCC
GACGCATTTGC -> ACGCATTTGCG
GACGCTCAGGC -> ACGCTCAGGCA
GACGGCTGGAG -> ACGGCTGGAGA
GACGGTTGCCA -> ACGGTTGCCAG
GACTACGCGGA -> ACTACGCGGAG
GACTGAACGGG -> ACTGAACGGGA
GACTGATTGAG -> ACTGATTGAGT
GACTTGTGCAG -> ACTTGTGCAGC
GACTTTTTACA -> ACTTTTTACAG
GAGAGCTTTCT -> AGAGCTTTCTT
GAGAGTGTCAG -> AGAGTGTCAGA
GAGATCGCACA -> AGATCGCACAT
GAGCACGGTGG -> AGCACGGTGGC
GAGCACTCCCA -> AGCACTCCCAG
GAGCCGAACGA -> AGCCGAACGAA
GAGCCTTCTGG -> AGCCTTCTGGC
GAGCGGGCACG -> AGCGGGCACGG
GAGCGGGGCCA -> AGCGGGGCCAT
GAGCGGTTCCT -> AGCGGTTCCTT
GAGCTACTGTA -> AGCTACTGTAA
GAGCTTTCTTC -> AGCTTTCTTCG
GAGGACACATG -> AGGACACATGC
GAGGATCTTAC -> AGGATCTTACG
GAGGCGAACAA -> AGGCGAACAAC
GAGGGAGCCGA -> AGGGAGCCGAA
GAGGGCCGTGC -> AGGGCCGTGCG
GAGGGCGTCTT -> AGGGCGTCTTT
GAGGGCTCACC -> AGGGCTCACCA
GAGGTGGAAAC -> AGGTGGAAACC
GAGTACTGACA -> AGTACTGACAG
GAGTATCCCCA -> AGTATCCCCAG
GAGTCAGCCCC -> AGTCAGCCCCC
GAGTCGGTGGG -> AGTCGGTGGGG
GAGTCTGAGCT -> AGTCTGAGCTA
GAGTGTCAGAA -> AGTGTCAGAAT
GAGTTAGATAC -> AGTTAGATACC
GAGTTTTATGT -> AGTTTTATGTG
GATAAATGAGG -> ATAAATGAGGG
GATAATGTAAA -> ATAATGTAAAT
GATACATTCGA -> ATACATTCGAA
GATACCTAGCG -> ATACCTAGCGA
GATACGATTCC -> ATACGATTCCT
GATACGTCCCA -> ATACGTCCCAT
GATATCACAGT -> ATATCACAGTT
GATCATCAAAC -> ATCATCAAACA
GATCCATCCCC -> ATCCATCCCCT
GATCCGAACAA -> ATCCGAACAAC
GATCCGGGTAA -> ATCCGGGTAAT
GATCGAACTAA -> ATCGAACTAAC
GATCGCACATT -> ATCGCACATTG
GATCGTGGGCT -> ATCGTGGGCTG
GATCTAGGACG -> ATCTAGGACGA
GATCTCGCATC -> ATCTCGCATCC
GATCTTACGAA -> ATCTTACGAAT
GATCTTATACC -> ATCTTATACCT
GATCTTCAGAG -> ATCTTCAGAGA
GATGACCAGGC -> ATGACCAGGCC
GATGATCCGGG -> ATGATCCGGGT
GATGCTCCCGA -> ATGCTCCCGAG
GATGGCACATT -> ATGGCACATTA
GATGTAAACAG -> ATGTAAACAGC
GATGTAGGCGT -> ATGTAGGCGTT
GATGTCCGGGT -> ATGTCCGGGTG
GATGTCGGAGG -> ATGTCGGAGGG
GATTCCTGCTG -> ATTCCTGCTGA
GATTCGGAATA -> ATTCGGAATAG
GATTGAGTCAG -> ATTGAGTCAGC
GATTGGTGGTC -> ATTGGTGGTCA
GCAAACGACTT -> CAAACGACTTG
GCAACCTAACC -> CAACCTAACCT
GCAACTACCTA -> CAACTACCTAC
GCAACTTATTC -> CAACTTATTCG
GCAAGAGCGGG -> CAAGAGCGGGG
GCAATATCGAG -> CAATATCGAGG
GCAATGAAGAT -> CAATGAAGATA
GCACAAATCCG -> CACAAATCCGA
GCACAAATCTC -> CACAAATCTCA
GCACACGATAA -> CACACGATAAA
GCACAGGTCGC -> CACAGGTCGCA
GCACATTAGAC -> CACATTAGACC
GCACATTGCTC -> CACATTGCTCC
GCACGATCCGA -> CACGATCCGAA
GCACGGTCTGG -> CACGGTCTGGT
GCACGGTGGCA -> CACGGTGGCAT
GCACTACGTTC -> CACTACGTTCG
GCACTCCCAGA -> CACTCCCAGAA
GCACTCGGAAC -> CACTCGGAACA
GCACTGTCCAT -> CACTGTCCATT
GCAGATACGAT -> CAGATACGATT
GCAGCGGGTTG -> CAGCGGGTTGA
GCAGCTCTTCT -> CAGCTCTTCTA
GCAGGAGTTTT -> CAGGAGTTTTA
GCAGGGCGCGA -> CAGGGCGCGAC
GCATAACGCTC -> CATAACGCTCT
GCATAAGCCGC -> CATAAGCCGCA
GCATAGCCCTT -> CATAGCCCTTC
GCATCAAGAAC -> CATCAAGAACG
GCATCAAGGTC -> CATCAAGGTCC
GCATCCCCAAT -> CATCCCCAATC
GCATGAAATGG -> CATGAAATGGC
GCATTTGCGGC -> CATTTGCGGCA
GCCAAACTCAG -> CCAAACTCAGG
GCCACGCCGCG -> CCACGCCGCGC
GCCACGCTACG -> CCACGCTACGG
GCCAGAGTCGG -> CCAGAGTCGGT
GCCAGGTGCCT -> CCAGGTGCCTA
GCCAGTTCTAC -> CCAGTTCTACG
GCCATCGTTAG -> CCATCGTTAGT
GCCATGGATGG -> CCATGGATGGC
GCCCACTCAGC -> CCCACTCAGCT
GCCCCAGCGTC -> CCCCAGCGTCA
GCCCCCAGGTC -> CCCCCAGGTCT
GCCCGACTGAA -> CCCGACTGAAC
GCCCGATGACC -> CCCGATGACCA
GCCCTGGTAAA -> CCCTGGTAAAT
GCCCTTCGCCG -> CCCTTCGCCGC
GCCGAACGAAG -> CCGAACGAAGG
GCCGACGCATT -> CCGACGCATTT
GCCGCAAACGA -> CCGCAAACGAC
GCCGCAACTAC -> CCGCAACTACC
GCCGCCTCCCA -> CCGCCTCCCAT
GCCGCGCCTGT -> CCGCGCCTGTC
GCCGCGCTAGC -> CCGCGCTAGCT
GCCGGTACAAG -> CCGGTACAAGG
GCCGTCTTTAA -> CCGTCTTTAAT
GCCGTGCGGTG -> CCGTGCGGTGA
GCCTATTGTCA -> CCTATTGTCAT
GCCTCCCATTC -> CCTCCCATTCG
GCCTCGGTTTT -> CCTCGGTTTTA
GCCTGTCGGCG -> CCTGTCGGCGA
GCCTTCTGGCG -> CCTTCTGGCGC
GCGAACAACGC -> CGAACAACGCG
GCGACACGGGC -> CGACACGGGCA
GCGACAGAAAG -> CGACAGAAAGA
GCGACAGGTTT -> CGACAGGTTTC
GCGACATTCTC -> CGACATTCTCG
GCGATCTTCAG -> CGATCTTCAGA
GCGATGTCCGG -> CGATGTCCGGG
GCGCAACTTAT -> CGCAACTTATT
GCGCAAGAGCG -> CGCAAGAGCGG
GCGCATGAAAT -> CGCATGAAATG
GCGCCAAACTC -> CGCCAAACTCA
GCGCCTGTCGG -> CGCCTGTCGGC
GCGCGACAGAA -> CGCGACAGAAA
GCGCGCCAAAC -> CGCGCCAAACT
GCGCTAGCTAC -> CGCTAGCTACG
GCGGAAGGTGC -> CGGAAGGTGCA
GCGGAGATCGC -> CGGAGATCGCA
GCGGCAATGAA -> CGGCAATGAAG
GCGGCTCTTGT -> CGGCTCTTGTA
GCGGGAAGCTT -> CGGGAAGCTTA
GCGGGCACGGT -> CGGGCACGGTC
GCGGGGCCATC -> CGGGGCCATCG
GCGGGTTGACA -> CGGGTTGACAT
GCGGTGAAGCT -> CGGTGAAGCTT
GCGGTTCCTTT -> CGGTTCCTTTC
GCGTCAGGTTT -> CGTCAGGTTTC
GCGTCTTTTTT -> CGTCTTTTTTG
GCGTGAGCGGG -> CGTGAGCGGGC
GCGTTATTTGC -> CGTTATTTGCC
GCTAAGCTGGT -> CTAAGCTGGTC
GCTACGGACTA -> CTACGGACTAC
GCTACGGGTAG -> CTACGGGTAGT
GCTACTGTAAT -> CTACTGTAATT
GCTAGCTACGG -> CTAGCTACGGA
GCTATACCCGT -> CTATACCCGTG
GCTCACCACCA -> CTCACCACCAC
GCTCAGGCACT -> CTCAGGCACTA
GCTCCCGAGTT -> CTCCCGAGTTA
GCTCCCGGACG -> CTCCCGGACGA
GCTCCGAACAG -> CTCCGAACAGG
GCTCCGAAGTA -> CTCCGAAGTAC
GCTCCTGGATC -> CTCCTGGATCA
GCTCGATCGAA -> CTCGATCGAAC
GCTCTCAGGCC -> CTCTCAGGCCA
GCTCTGAAGCA -> CTCTGAAGCAC
GCTCTTCTATT -> CTCTTCTATTG
GCTCTTGTACA -> CTCTTGTACAG
GCTGAGCACTC -> CTGAGCACTCC
GCTGAGGACAC -> CTGAGGACACA
GCTGCAGGGCG -> CTGCAGGGCGC
GCTGGAGAGTG -> CTGGAGAGTGT
GCTGGTCCCCC -> CTGGTCCCCCG
GCTGTCGTTAG -> CTGTCGTTAGT
GCTTAGACCAA -> CTTAGACCAAA
GCTTCGGGCGC -> CTTCGGGCGCA
GCTTGCAGATA -> CTTGCAGATAC
GCTTTCTTCGG -> CTTTCTTCGGA
GGAAAAACTAT -> GAAAAACTATC
GGAAACCCCTT -> GAAACCCCTTA
GGAAATGGCGC -> GAAATGGCGCG
GGAACAGCCCA -> GAACAGCCCAC
GGAAGCTTAGA -> GAAGCTTAGAC
GGAAGGATAAT -> GAAGGATAATG
GGAAGGTGCAG -> GAAGGTGCAGG
GGAAGTTGGAT -> GAAGTTGGATT
GGAATAGTTAC -> GAATAGTTACG
GGACACATGCT -> GACACATGCTG
GGACAGGGCCC -> GACAGGGCCCT
GGACCTCTCCA -> GACCTCTCCAT
GGACGAGGGCT -> GACGAGGGCTC
GGACGAGTATC -> GACGAGTATCC
GGACGCTCAGG -> GACGCTCAGGC
GGACGGTTGCC -> GACGGTTGCCA
GGACTACGCGG -> GACTACGCGGA
GGAGAGTGTCA -> GAGAGTGTCAG
GGAGATCGCAC -> GAGATCGCACA
GGAGCCGAACG -> GAGCCGAACGA
GGAGCCTTCTG -> GAGCCTTCTGG
GGAGGATCTTA -> GAGGATCTTAC
GGAGGCGAACA -> GAGGCGAACAA
GGAGGGCGTCT -> GAGGGCGTCTT
GGAGTTTTATG -> GAGTTTTATGT
GGATAATGTAA -> GATAATGTAAA
GGATACATTCG -> GATACATTCGA
GGATCATCAAA -> GATCATCAAAC
GGATCTCGCAT -> GATCTCGCATC
GGATCTTACGA -> GATCTTACGAA
GGATGGCACAT -> GATGGCACATT
GGATTGGTGGT -> GATTGGTGGTC
GGCAATGAAGA -> GCAATGAAGAT
GGCACATTAGA -> GCACATTAGAC
GGCACGATCCG -> GCACGATCCGA
GGCACGGTCTG -> GCACGGTCTGG
GGCACTACGTT -> GCACTACGTTC
GGCAGCTCTTC -> GCAGCTCTTCT
GGCATAACGCT -> GCATAACGCTC
GGCATCAAGAA -> GCATCAAGAAC
GGCATCAAGGT -> GCATCAAGGTC
GGCCACGCCGC -> GCCACGCCGCG
GGCCACGCTAC -> GCCACGCTACG
GGCCATCGTTA -> GCCATCGTTAG
GGCCCGACTGA -> GCCCGACTGAA
GGCCCGATGAC -> GCCCGATGACC
GGCCCTGGTAA -> GCCCTGGTAAA
GGCCGCCTCCC -> GCCGCCTCCCA
GGCCGTGCGGT -> GCCGTGCGGTG
GGCCTCGGTTT -> GCCTCGGTTTT
GGCGAACAACG -> GCGAACAACGC
GGCGACACGGG -> GCGACACGGGC
GGCGATGTCCG -> GCGATGTCCGG
GGCGCAACTTA -> GCGCAACTTAT
GGCGCATGAAA -> GCGCATGAAAT
GGCGCGACAGA -> GCGCGACAGAA
GGCGCGCCAAA -> GCGCGCCAAAC
GGCGGAAGGTG -> GCGGAAGGTGC
GGCGTCTTTTT -> GCGTCTTTTTT
GGCGTTATTTG -> GCGTTATTTGC
GGCTATACCCG -> GCTATACCCGT
GGCTCACCACC -> GCTCACCACCA
GGCTCCCGGAC -> GCTCCCGGACG
GGCTCTTGTAC -> GCTCTTGTACA
GGCTGAGGACA -> GCTGAGGACAC
GGCTGGAGAGT -> GCTGGAGAGTG
GGGAAAAACTA -> GGAAAAACTAT
GGGAAGCTTAG -> GGAAGCTTAGA
GGGAAGTTGGA -> GGAAGTTGGAT
GGGACAGGGCC -> GGACAGGGCCC
GGGACGCTCAG -> GGACGCTCAGG
GGGACGGTTGC -> GGACGGTTGCC
GGGAGCCGAAC -> GGAGCCGAACG
GGGAGGATCTT -> GGAGGATCTTA
GGGCACGGTCT -> GGCACGGTCTG
GGGCAGCTCTT -> GGCAGCTCTTC
GGGCATAACGC -> GGCATAACGCT
GGGCCATCGTT -> GGCCATCGTTA
GGGCCCGACTG -> GGCCCGACTGA
GGGCCCTGGTA -> GGCCCTGGTAA
GGGCCGCCTCC -> GGCCGCCTCCC
GGGCCGTGCGG -> GGCCGTGCGGT
GGGCGCATGAA -> GGCGCATGAAA
GGGCGCGACAG -> GGCGCGACAGA
GGGCGTCTTTT -> GGCGTCTTTTT
GGGCTCACCAC -> GGCTCACCACC
GGGCTGAGGAC -> GGCTGAGGACA
GGGGCAGCTCT -> GGGCAGCTCTT
GGGGCCATCGT -> GGGCCATCGTT
GGGGCCGCCTC -> GGGCCGCCTCC
GGGGTAGAAGT -> GGGTAGAAGTC
GGGGTTAAGTC -> GGGTTAAGTCC
GGGTAATCTTC -> GGTAATCTTCC
GGGTAGAAGTC -> GGTAGAAGTCT
GGGTAGTCCTT -> GGTAGTCCTTT
GGGTGTTCCAG -> GGTGTTCCAGA
GGGTTAAGTCC -> GGTTAAGTCCA
GGGTTGACATC -> GGTTGACATCG
GGTAAATTAGC -> GTAAATTAGCC
GGTAACAAACA -> GTAACAAACAC
GGTAACTTGCA -> GTAACTTGCAT
GGTAATCTTCC -> GTAATCTTCCG
GGTACAAGGTA -> GTACAAGGTAA
GGTAGAAGTCT -> GTAGAAGTCTC
GGTAGTCCTTT -> GTAGTCCTTTC
GGTATCCCTCT -> GTATCCCTCTA
GGTCACGGTCG -> GTCACGGTCGC
GGTCATCTTGT -> GTCATCTTGTG
GGTCCCCCGGT -> GTCCCCCGGTG
GGTCCGAACCA -> GTCCGAACCAT
GGTCCTCTCTA -> GTCCTCTCTAG
GGTCCTGTGGA -> GTCCTGTGGAC
GGTCGCAATAT -> GTCGCAATATC
GGTCGCCAGAG -> GTCGCCAGAGT
GGTCTACCATA -> GTCTACCATAG
GGTCTAGGGCC -> GTCTAGGGCCC
GGTCTGGTTTG -> GTCTGGTTTGA
GGTCTTACAGT -> GTCTTACAGTT
GGTGAAGCTTG -> GTGAAGCTTGC
GGTGCACAGGT -> GTGCACAGGTC
GGTGCAGGAGT -> GTGCAGGAGTT
GGTGCCTATTG -> GTGCCTATTGT
GGTGGAAACCC -> GTGGAAACCCC
GGTGGCATCAA -> GTGGCATCAAG
GGTGGGGCAGC -> GTGGGGCAGCT
GGTGGGGCCGC -> GTGGGGCCGCC
GGTGGTCATCT -> GTGGTCATCTT
GGTGTTCCAGA -> GTGTTCCAGAT
GGTTAAGTCCA -> GTTAAGTCCAC
GGTTATGAGCA -> GTTATGAGCAC
GGTTCCTTTCA -> GTTCCTTTCAT
GGTTGAACCGC -> GTTGAACCGCC
GGTTGACACTA -> GTTGACACTAA
GGTTGACATCG -> GTTGACATCGT
GGTTGCCAGGT -> GTTGCCAGGTG
GGTTGGTAACA -> GTTGGTAACAA
GGTTTCCCAGT -> GTTTCCCAGTT
GGTTTCCGGAG -> GTTTCCGGAGC
GGTTTCTACCT -> GTTTCTACCTT
GGTTTGAAGTT -> GTTTGAAGTTC
GGTTTTAGTCA -> GTTTTAGTCAT
GTAAAAGCTCT -> TAAAAGCTCTG
GTAAACAGCCG -> TAAACAGCCGG
GTAAATTAGCC -> TAAATTAGCCG
GTAAATTCATG -> TAAATTCATGG
GTAACAAACAC -> TAACAAACACA
GTAACTTGCAT -> TAACTTGCATA
GTAAGGAAGGA -> TAAGGAAGGAT
GTAATCTCGTA -> TAATCTCGTAA
GTAATCTTCCG -> TAATCTTCCGA
GTAATTTACGC -> TAATTTACGCC
GTAATTTCACT -> TAATTTCACTC
GTACAAGGTAA -> TACAAGGTAAC
GTACAGACGGC -> TACAGACGGCT
GTACATTGTCT -> TACATTGTCTG
GTACCTCCCCC -> TACCTCCCCCT,TACCTCCCCCT
GTACTGACAGT -> TACTGACAGTA
GTAGAAGTCTC -> TAGAAGTCTCG
GTAGGCGTTAT -> TAGGCGTTATT
GTAGGGGTAGA -> TAGGGGTAGAA
GTAGGTGGGGC -> TAGGTGGGGCC
GTAGGTTGGTA -> TAGGTTGGTAA
GTAGTCCTTTC -> TAGTCCTTTCG
GTAGTGTTTGG -> TAGTGTTTGGG
GTATCCCCAGA -> TATCCCCAGAG
GTATCCCTCTA -> TATCCCTCTAA
GTATGTGAAGT -> TATGTGAAGTG
GTATTGGCCAC -> TATTGGCCACG
GTCACGGTCGC -> TCACGGTCGCC
GTCAGAATCTC -> TCAGAATCTCA
GTCAGCCCCCA -> TCAGCCCCCAG
GTCAGGTTTCT -> TCAGGTTTCTA
GTCATCCTACG -> TCATCCTACGC
GTCATCTTGTG -> TCATCTTGTGC
GTCATGGTCTA -> TCATGGTCTAG
GTCCACTGATG -> TCCACTGATGC
GTCCATTACGT -> TCCATTACGTT
GTCCCATTCAT -> TCCCATTCATA
GTCCCCCGGTG -> TCCCCCGGTGC
GTCCGAACCAT -> TCCGAACCATC
GTCCGGGTGTT -> TCCGGGTGTTC
GTCCTCTCTAG -> TCCTCTCTAGA
GTCCTGTGGAC -> TCCTGTGGACC
GTCCTTTCGAA -> TCCTTTCGAAG
GTCGCAATATC -> TCGCAATATCG
GTCGCCAGAGT -> TCGCCAGAGTC
GTCGGAGGGCG -> TCGGAGGGCGT
GTCGGCGACAC -> TCGGCGACACG
GTCGGTGGGGC -> TCGGTGGGGCA
GTCGTTAGTGC -> TCGTTAGTGCT
GTCTACCATAG -> TCTACCATAGT
GTCTAGGGCCC -> TCTAGGGCCCG
GTCTCCTAGAA -> TCTCCTAGAAG
GTCTCGGTCTT -> TCTCGGTCTTA
GTCTGAGCTAC -> TCTGAGCTACT
GTCTGCACACG -> TCTGCACACGA
GTCTGGTTTGA -> TCTGGTTTGAA
GTCTTACAGTT -> TCTTACAGTTA
GTCTTTAATCA -> TCTTTAATCAC
GTCTTTTTTGA -> TCTTTTTTGAT
GTGAAGCTTGC -> TGAAGCTTGCA
GTGAAGTGGTC -> TGAAGTGGTCC
GTGACTTTTTA -> TGACTTTTTAC
GTGAGCGGGCA -> TGAGCGGGCAC
GTGAGCGGTTC -> TGAGCGGTTCC
GTGCACAGGTC -> TGCACAGGTCG
GTGCAGCGGGT -> TGCAGCGGGTT
GTGCAGGAGTT -> TGCAGGAGTTT
GTGCCTATTGT -> TGCCTATTGTC
GTGCGCAAGAG -> TGCGCAAGAGC
GTGCGGTGAAG -> TGCGGTGAAGC
GTGCTTCGGGC -> TGCTTCGGGCG
GTGGAAACCCC -> TGGAAACCCCT
GTGGACCTCTC -> TGGACCTCTCC
GTGGCATCAAG -> TGGCATCAAGG
GTGGCCCGATG -> TGGCCCGATGA
GTGGGACGCTC -> TGGGACGCTCA
GTGGGCTGAGG -> TGGGCTGAGGA
GTGGGGCAGCT -> TGGGGCAGCTC
GTGGGGCCGCC -> TGGGGCCGCCT
GTGGTCATCTT -> TGGTCATCTTG
GTGGTCCTGTG -> TGGTCCTGTGG
GTGTCAGAATC -> TGTCAGAATCT
GTGTGGGACGC -> TGTGGGACGCT
GTGTTCCAGAT -> TGTTCCAGATC
GTGTTTGGGAG -> TGTTTGGGAGG
GTTAAGAAGAG -> TTAAGAAGAGG
GTTAAGTCCAC -> TTAAGTCCACT
GTTAATCCGCG -> TTAATCCGCGG
GTTAATTCTAT -> TTAATTCTATA
GTTACACGGCG -> TTACACGGCGG
GTTACCGGTCA -> TTACCGGTCAC
GTTACGCTGCA -> TTACGCTGCAG
GTTAGATACCT -> TTAGATACCTA
GTTAGTCTCCT -> TTAGTCTCCTA
GTTAGTGCTTC -> TTAGTGCTTCG
GTTATGAGCAC -> TTATGAGCACG
GTTATTTGCCG -> TTATTTGCCGC
GTTCAAACCTG -> TTCAAACCTGT
GTTCCAGATCT -> TTCCAGATCTA
GTTCCTTTCAT -> TTCCTTTCATC
GTTCGGCTATA -> TTCGGCTATAC
GTTCTACGTGG -> TTCTACGTGGC
GTTGAACCGCC -> TTGAACCGCCA
GTTGACACTAA -> TTGACACTAAG
GTTGACATCGT -> TTGACATCGTG
GTTGCCAGGTG -> TTGCCAGGTGC
GTTGGATTGGT -> TTGGATTGGTG
GTTGGTAACAA -> TTGGTAACAAA
GTTGTATTGGC -> TTGTATTGGCC
GTTGTTAATTC -> TTGTTAATTCT
GTTTCCCAGTT -> TTTCCCAGTTA
GTTTCCGGAGC -> TTTCCGGAGCC
GTTTCTACCTT -> TTTCTACCTTT
GTTTGAAACAT -> TTTGAAACATA
GTTTGAAGTTC -> TTTGAAGTTCA
GTTTGATATCA -> TTTGATATCAC
GTTTGGGAGGA -> TTTGGGAGGAT
GTTTTAGTCAT -> TTTTAGTCATG
GTTTTATGTGA -> TTTTATGTGAC
TAAAAGCTCTG -> AAAAGCTCTGA
TAAACAGCCGG -> AAACAGCCGGT
TAAACGGAAAT -> AAACGGAAATG
TAAATGAGGGA -> AAATGAGGGAG
TAAATTAGCCG -> AAATTAGCCGT
TAAATTCATGG -> AAATTCATGGG
TAACAAACACA -> AACAAACACAG
TAACCTATCGG -> AACCTATCGGG
TAACGCTCTCA -> AACGCTCTCAG
TAACGGCTCCC -> AACGGCTCCCG
TAACGTACATT -> AACGTACATTG
TAACTTCGGGA -> AACTTCGGGAC
TAACTTGCATA -> AACTTGCATAA
TAAGAAAGGGA -> AAGAAAGGGAA
TAAGAAGAGGG -> AAGAAGAGGGC
TAAGCCGCAAC -> AAGCCGCAACT
TAAGCTGGTCC -> AAGCTGGTCCC
TAAGGAAGGAT -> AAGGAAGGATA
TAAGGTCCTCT -> AAGGTCCTCTC
TAAGTCCACTG -> AAGTCCACTGA
TAATAAACGGA -> AATAAACGGAA
TAATCACCCAG -> AATCACCCAGG
TAATCCGCGGC -> AATCCGCGGCT
TAATCTCGTAA -> AATCTCGTAAA
TAATCTTCCGA -> AATCTTCCGAT
TAATGTAAATT -> AATGTAAATTC
TAATTCTATAT -> AATTCTATATG
TAATTTACGCC -> AATTTACGCCA
TAATTTCACTC -> AATTTCACTCT
TACAAGGTAAC -> ACAAGGTAACT
TACACGGCGGA -> ACACGGCGGAA
TACAGACGGCT -> ACAGACGGCTG
TACAGTAGGGG -> ACAGTAGGGGT
TACAGTTAATC -> ACAGTTAATCC
TACATTCGAAG -> ACATTCGAAGG
TACATTGTCTG -> ACATTGTCTGC
TACCATAGTTA -> ACCATAGTTAC
TACCCGTGAGC -> ACCCGTGAGCG
TACCGGTCACG -> ACCGGTCACGG
TACCTACTAAT -> ACCTACTAATA
TACCTAGCGAT -> ACCTAGCGATC
TACCTCCCCCT -> ACCTCCCCCTA,ACCTCCCCCTA
TACCTGACCGC -> ACCTGACCGCT
TACCTTCATAC -> ACCTTCATACC
TACCTTTCTTT -> ACCTTTCTTTA
TACGAATTTCC -> ACGAATTTCCG
TACGATTCCTG -> ACGATTCCTGC
TACGCCAGTTC -> ACGCCAGTTCT
TACGCCCCAGC -> ACGCCCCAGCG
TACGCGGAGAT -> ACGCGGAGATC
TACGCTGCAGG -> ACGCTGCAGGG
TACGGACTACG -> ACGGACTACGC
TACGGGTAGTC -> ACGGGTAGTCC
TACGTCCCATT -> ACGTCCCATTC
TACGTGGCCCG -> ACGTGGCCCGA
TACGTTCGGCT -> ACGTTCGGCTA
TACGTTTGAAA -> ACGTTTGAAAC
TACTAATAAAC -> ACTAATAAACG
TACTGACAGTA -> ACTGACAGTAG
TACTGGATCTC -> ACTGGATCTCG
TACTGTAATTT -> ACTGTAATTTC
TAGAAGGCACG -> AGAAGGCACGA
TAGAAGTCTCG -> AGAAGTCTCGG
TAGACCAAAAA -> AGACCAAAAAG
TAGACCACAGC -> AGACCACAGCT
TAGACCGCAAC -> AGACCGCAACC
TAGACGAAATT -> AGACGAAATTC
TAGATACCTAG -> AGATACCTAGC
TAGATGTCGGA -> AGATGTCGGAG
TAGCCCTTCGC -> AGCCCTTCGCC
TAGCCGTCTTT -> AGCCGTCTTTA
TAGCGATCTTC -> AGCGATCTTCA
TAGCTACGGAC -> AGCTACGGACT
TAGGACGAGTA -> AGGACGAGTAT
TAGGCGTTATT -> AGGCGTTATTT
TAGGGCCCGAC -> AGGGCCCGACT
TAGGGGTAGAA -> AGGGGTAGAAG
TAGGTGGGGCC -> AGGTGGGGCCG
TAGGTTGAACC -> AGGTTGAACCG
TAGGTTGGTAA -> AGGTTGGTAAC
TAGTCATGGTC -> AGTCATGGTCT
TAGTCCTTTCG -> AGTCCTTTCGA
TAGTCTCCTAG -> AGTCTCCTAGA
TAGTGCTTCGG -> AGTGCTTCGGG
TAGTGTTTGGG -> AGTGTTTGGGA
TAGTTACCGGT -> AGTTACCGGTC
TAGTTACGCTG -> AGTTACGCTGC
TATACCCGTGA -> ATACCCGTGAG
TATACCTTCAT -> ATACCTTCATA
TATATGCGTGA -> ATATGCGTGAG
TATATGTAGTG -> ATATGTAGTGT
TATCACAGTTG -> ATCACAGTTGT
TATCCCAGCAC -> ATCCCAGCACT
TATCCCCAGAG -> ATCCCCAGAGT
TATCCCTCTAA -> ATCCCTCTAAC
TATCGAGGTGG -> ATCGAGGTGGA
TATCGATGATC -> ATCGATGATCC
TATCGGGGTTA -> ATCGGGGTTAA
TATCTTGTAAG -> ATCTTGTAAGG
TATGAGCACGG -> ATGAGCACGGT
TATGATCCATC -> ATGATCCATCC
TATGCGTGAGC -> ATGCGTGAGCG
TATGTAGTGTT -> ATGTAGTGTTT
TATGTGAAGTG -> ATGTGAAGTGG
TATGTGACTTT -> ATGTGACTTTT
TATTCGATCGT -> ATTCGATCGTG
TATTGCATAGC -> ATTGCATAGCC
TATTGGCCACG -> ATTGGCCACGC
TATTGTCATCC -> ATTGTCATCCT
TATTTGCCGCG -> ATTTGCCGCGC
TCAAACAATCC -> CAAACAATCCT
TCAAACCTGTA -> CAAACCTGTAA
TCAAGAACGCG -> CAAGAACGCGA
TCAAGGTCCGA -> CAAGGTCCGAA
TCACAGTTGTA -> CACAGTTGTAT
TCACCACCACT -> CACCACCACTG
TCACCCAGGTA -> CACCCAGGTAT
TCACGCTAAGC -> CACGCTAAGCT
TCACGGTCGCC -> CACGGTCGCCA
TCACTCTTGCG -> CACTCTTGCGG
TCAGAATCTCA -> CAGAATCTCAC
TCAGAGAGCTT -> CAGAGAGCTTT
TCAGCCCCCAG -> CAGCCCCCAGG
TCAGCTCCTGG -> CAGCTCCTGGA
TCAGGCACTAC -> CAGGCACTACG
TCAGGCCACGC -> CAGGCCACGCT
TCAGGTTGACA -> CAGGTTGACAC
TCAGGTTTCTA -> CAGGTTTCTAC
TCATACCTGAC -> CATACCTGACC
TCATACTGGAT -> CATACTGGATC
TCATCAAACAA -> CATCAAACAAT
TCATCCTACGC -> CATCCTACGCC
TCATCCTCTAT -> CATCCTCTATC
TCATCTTGTGC -> CATCTTGTGCG
TCATGCACAAA -> CATGCACAAAT
TCATGGGAAGT -> CATGGGAAGTT
TCATGGTCTAG -> CATGGTCTAGG
TCCACTGATGC -> CCACTGATGCT
TCCAGATCTAG -> CCAGATCTAGG
TCCATCCCCTT -> CCATCCCCTTG
TCCATCGAACT -> CCATCGAACTA
TCCATTACGTT -> CCATTACGTTT
TCCCAGAAAAC -> CCCAGAAAACT
TCCCAGCACTG -> CCCAGCACTGT
TCCCAGTTAAG -> CCCAGTTAAGA
TCCCATTCATA -> CCCATTCATAC
TCCCATTCGTT -> CCCATTCGTTG
TCCCCAATCTA -> CCCCAATCTAG
TCCCCAGAGTA -> CCCCAGAGTAC
TCCCCCGGTGC -> CCCCCGGTGCA
TCCCCCTAACG -> CCCCCTAACGG
TCCCCCTAGAC -> CCCCCTAGACG
TCCCCTTGTTA -> CCCCTTGTTAC
TCCCGAGTTAG -> CCCGAGTTAGA
TCCCGGACGAG -> CCCGGACGAGG
TCCCTCTAACG -> CCCTCTAACGT
TCCGAACAACT -> CCGAACAACTG
TCCGAACAGGT -> CCGAACAGGTT
TCCGAACCATC -> CCGAACCATCG
TCCGAAGTACC -> CCGAAGTACCT
TCCGAGTCTGA -> CCGAGTCTGAG
TCCGATTCGGA -> CCGATTCGGAA
TCCGCACAAAT -> CCGCACAAATC
TCCGCGGCTCT -> CCGCGGCTCTT
TCCGGAGCCTT -> CCGGAGCCTTC
TCCGGGTAATC -> CCGGGTAATCT
TCCGGGTGTTC -> CCGGGTGTTCC
TCCTACGCCCC -> CCTACGCCCCA
TCCTAGAAGGC -> CCTAGAAGGCA
TCCTCTATCGA -> CCTCTATCGAT
TCCTCTCTAGA -> CCTCTCTAGAT
TCCTGCTGAGC -> CCTGCTGAGCA
TCCTGGATCAT -> CCTGGATCATC
TCCTGTGGACC -> CCTGTGGACCT
TCCTTATATGT -> CCTTATATGTA
TCCTTTCATCC -> CCTTTCATCCT
TCCTTTCGAAG -> CCTTTCGAAGT
TCGAACTAACT -> CGAACTAACTT
TCGAACTAGTT -> CGAACTAGTTT
TCGAAGGTTAT -> CGAAGGTTATG
TCGAAGTAGGT -> CGAAGTAGGTT
TCGAGGTGGAA -> CGAGGTGGAAA
TCGATCGAACT -> CGATCGAACTA
TCGATCGTGGG -> CGATCGTGGGC
TCGATGATCCG -> CGATGATCCGG
TCGCAATATCG -> CGCAATATCGA
TCGCACATTGC -> CGCACATTGCT
TCGCATCCCCA -> CGCATCCCCAA
TCGCCAGAGTC -> CGCCAGAGTCG
TCGCCGCAAAC -> CGCCGCAAACG
TCGGAACAGCC -> CGGAACAGCCC
TCGGAATAGTT -> CGGAATAGTTA
TCGGAGGGCGT -> CGGAGGGCGTC
TCGGATACATT -> CGGATACATTC
TCGGCGACACG -> CGGCGACACGG
TCGGCGATGTC -> CGGCGATGTCC
TCGGCTATACC -> CGGCTATACCC
TCGGGACAGGG -> CGGGACAGGGC
TCGGGCGCATG -> CGGGCGCATGA
TCGGGGTTAAG -> CGGGGTTAAGT
TCGGTCTTACA -> CGGTCTTACAG
TCGGTGGGGCA -> CGGTGGGGCAG
TCGGTTTTAGT -> CGGTTTTAGTC
TCGTAAAAGCT -> CGTAAAAGCTC
TCGTACCTCCC -> CGTACCTCCCC
TCGTATGTGAA -> CGTATGTGAAG
TCGTGGGCTGA -> CGTGGGCTGAG
TCGTGTGGGAC -> CGTGTGGGACG
TCGTTAGTCTC -> CGTTAGTCTCC
TCGTTAGTGCT -> CGTTAGTGCTT
TCGTTGTTAAT -> CGTTGTTAATT
TCTAACGTACA -> CTAACGTACAT
TCTACCATAGT -> CTACCATAGTT
TCTACCTTTCT -> CTACCTTTCTT
TCTACGTGGCC -> CTACGTGGCCC
TCTAGACCACA -> CTAGACCACAG
TCTAGATGTCG -> CTAGATGTCGG
TCTAGGACGAG -> CTAGGACGAGT
TCTAGGGCCCG -> CTAGGGCCCGA
TCTATATGCGT -> CTATATGCGTG
TCTATCGATGA -> CTATCGATGAT
TCTATTGCATA -> CTATTGCATAG
TCTCACGCTAA -> CTCACGCTAAG
TCTCAGGCCAC -> CTCAGGCCACG
TCTCATGCACA -> CTCATGCACAA
TCTCCATCGAA -> CTCCATCGAAC
TCTCCTAGAAG -> CTCCTAGAAGG
TCTCGCATCCC -> CTCGCATCCCC
TCTCGGCGATG -> CTCGGCGATGT
TCTCGGTCTTA -> CTCGGTCTTAC
TCTCGTAAAAG -> CTCGTAAAAGC
TCTCTAGATGT -> CTCTAGATGTC
TCTGAAGCACT -> CTGAAGCACTC
TCTGAGCTACT -> CTGAGCTACTG
TCTGCACACGA -> CTGCACACGAT
TCTGGCGCAAC -> CTGGCGCAACT
TCTGGTTTGAA -> CTGGTTTGAAG
TCTTACAGTTA -> CTTACAGTTAA
TCTTACGAATT -> CTTACGAATTT
TCTTATACCTT -> CTTATACCTTC
TCTTCAGAGAG -> CTTCAGAGAGC
TCTTCCGATTC -> CTTCCGATTCG
TCTTCGGATAC -> CTTCGGATACA
TCTTCTATTGC -> CTTCTATTGCA
TCTTGCGGGAA -> CTTGCGGGAAG
TCTTGTAAGGA -> CTTGTAAGGAA
TCTTGTAATTT -> CTTGTAATTTA
TCTTGTACAGA -> CTTGTACAGAC
TCTTGTGCGCA -> CTTGTGCGCAA
TCTTTAATCAC -> CTTTAATCACC
TCTTTATCCCA -> CTTTATCCCAG
TCTTTTTTGAT -> CTTTTTTGATG
TGAAACATATG -> GAAACATATGA
TGAAATGGCAT -> GAAATGGCATC
TGAACCGCCAT -> GAACCGCCATG
TGAACGGGACG -> GAACGGGACGG
TGAAGATACGT -> GAAGATACGTC
TGAAGCACTCG -> GAAGCACTCGG
TGAAGCTTGCA -> GAAGCTTGCAG
TGAAGTGGTCC -> GAAGTGGTCCT
TGAAGTTCAAA -> GAAGTTCAAAC
TGACACTAAGA -> GACACTAAGAA
TGACAGTAGGT -> GACAGTAGGTG
TGACATCGTGT -> GACATCGTGTG
TGACCAGGCCT -> GACCAGGCCTC
TGACCGCTCCG -> GACCGCTCCGA
TGACTTTTTAC -> GACTTTTTACA
TGAGCACGGTG -> GAGCACGGTGG
TGAGCACTCCC -> GAGCACTCCCA
TGAGCGGGCAC -> GAGCGGGCACG
TGAGCGGTTCC -> GAGCGGTTCCT
TGAGCTACTGT -> GAGCTACTGTA
TGAGGACACAT -> GAGGACACATG
TGAGGGAGCCG -> GAGGGAGCCGA
TGAGTCAGCCC -> GAGTCAGCCCC
TGATATCACAG -> GATATCACAGT
TGATCCATCCC -> GATCCATCCCC
TGATCCGGGTA -> GATCCGGGTAA
TGATGCTCCCG -> GATGCTCCCGA
TGATGTAAACA -> GATGTAAACAG
TGATGTAGGCG -> GATGTAGGCGT
TGATTGAGTCA -> GATTGAGTCAG
TGCACAAATCC -> GCACAAATCCG
TGCACACGATA -> GCACACGATAA
TGCACAGGTCG -> GCACAGGTCGC
TGCAGATACGA -> GCAGATACGAT
TGCAGCGGGTT -> GCAGCGGGTTG
TGCAGGAGTTT -> GCAGGAGTTTT
TGCAGGGCGCG -> GCAGGGCGCGA
TGCATAAGCCG -> GCATAAGCCGC
TGCATAGCCCT -> GCATAGCCCTT
TGCCAGGTGCC -> GCCAGGTGCCT
TGCCGCGCTAG -> GCCGCGCTAGC
TGCCTATTGTC -> GCCTATTGTCA
TGCGCAAGAGC -> GCGCAAGAGCG
TGCGGCAATGA -> GCGGCAATGAA
TGCGGGAAGCT -> GCGGGAAGCTT
TGCGGTGAAGC -> GCGGTGAAGCT
TGCGTGAGCGG -> GCGTGAGCGGG
TGCTCCCGAGT -> GCTCCCGAGTT
TGCTCCGAACA -> GCTCCGAACAG
TGCTGAGCACT -> GCTGAGCACTC
TGCTGTCGTTA -> GCTGTCGTTAG
TGCTTCGGGCG -> GCTTCGGGCGC
TGGAAACCCCT -> GGAAACCCCTT
TGGACCTCTCC -> GGACCTCTCCA
TGGAGAGTGTC -> GGAGAGTGTCA
TGGATCATCAA -> GGATCATCAAA
TGGATCTCGCA -> GGATCTCGCAT
TGGATGGCACA -> GGATGGCACAT
TGGATTGGTGG -> GGATTGGTGGT
TGGCACATTAG -> GGCACATTAGA
TGGCATCAAGA -> GGCATCAAGAA
TGGCATCAAGG -> GGCATCAAGGT
TGGCCACGCCG -> GGCCACGCCGC
TGGCCCGATGA -> GGCCCGATGAC
TGGCGCAACTT -> GGCGCAACTTA
TGGCGCGCCAA -> GGCGCGCCAAA
TGGGAAGTTGG -> GGGAAGTTGGA
TGGGACGCTCA -> GGGACGCTCAG
TGGGAGGATCT -> GGGAGGATCTT
TGGGCTGAGGA -> GGGCTGAGGAC
TGGGGCAGCTC -> GGGGCAGCTCT
TGGGGCCGCCT -> GGGGCCGCCTC
TGGTAAATTAG -> GGTAAATTAGC
TGGTAACAAAC -> GGTAACAAACA
TGGTCATCTTG -> GGTCATCTTGT
TGGTCCCCCGG -> GGTCCCCCGGT
TGGTCCTGTGG -> GGTCCTGTGGA
TGGTCTAGGGC -> GGTCTAGGGCC
TGGTGGTCATC -> GGTGGTCATCT
TGGTTTGAAGT -> GGTTTGAAGTT
TGTAAACAGCC -> GTAAACAGCCG
TGTAAATTCAT -> GTAAATTCATG
TGTAAGGAAGG -> GTAAGGAAGGA
TGTAATCTCGT -> GTAATCTCGTA
TGTAATTTACG -> GTAATTTACGC
TGTAATTTCAC -> GTAATTTCACT
TGTACAGACGG -> GTACAGACGGC
TGTAGGCGTTA -> GTAGGCGTTAT
TGTAGTGTTTG -> GTAGTGTTTGG
TGTATTGGCCA -> GTATTGGCCAC
TGTCAGAATCT -> GTCAGAATCTC
TGTCATCCTAC -> GTCATCCTACG
TGTCCATTACG -> GTCCATTACGT
TGTCCGGGTGT -> GTCCGGGTGTT
TGTCGGAGGGC -> GTCGGAGGGCG
TGTCGGCGACA -> GTCGGCGACAC
TGTCGTTAGTG -> GTCGTTAGTGC
TGTCTGCACAC -> GTCTGCACACG
TGTGAAGTGGT -> GTGAAGTGGTC
TGTGACTTTTT -> GTGACTTTTTA
TGTGCAGCGGG -> GTGCAGCGGGT
TGTGCGCAAGA -> GTGCGCAAGAG
TGTGGACCTCT -> GTGGACCTCTC
TGTGGGACGCT -> GTGGGACGCTC
TGTTAATTCTA -> GTTAATTCTAT
TGTTACACGGC -> GTTACACGGCG
TGTTCCAGATC -> GTTCCAGATCT
TGTTTGATATC -> GTTTGATATCA
TGTTTGGGAGG -> GTTTGGGAGGA
TTAAGAAGAGG -> TAAGAAGAGGG
TTAAGTCCACT -> TAAGTCCACTG
TTAATCACCCA -> TAATCACCCAG
TTAATCCGCGG -> TAATCCGCGGC
TTAATTCTATA -> TAATTCTATAT
TTACACGGCGG -> TACACGGCGGA
TTACAGTAGGG -> TACAGTAGGGG
TTACAGTTAAT -> TACAGTTAATC
TTACCGGTCAC -> TACCGGTCACG
TTACGAATTTC -> TACGAATTTCC
TTACGCCAGTT -> TACGCCAGTTC
TTACGCTGCAG -> TACGCTGCAGG
TTACGTTTGAA -> TACGTTTGAAA
TTAGACCAAAA -> TAGACCAAAAA
TTAGACCGCAA -> TAGACCGCAAC
TTAGATACCTA -> TAGATACCTAG
TTAGCCGTCTT -> TAGCCGTCTTT
TTAGGTTGAAC -> TAGGTTGAACC
TTAGTCATGGT -> TAGTCATGGTC
TTAGTCTCCTA -> TAGTCTCCTAG
TTAGTGCTTCG -> TAGTGCTTCGG
TTATACCTTCA -> TATACCTTCAT
TTATATGTAGT -> TATATGTAGTG
TTATCCCAGCA -> TATCCCAGCAC
TTATGAGCACG -> TATGAGCACGG
TTATGTGACTT -> TATGTGACTTT
TTATTCGATCG -> TATTCGATCGT
TTATTTGCCGC -> TATTTGCCGCG
TTCAAACCTGT -> TCAAACCTGTA
TTCACTCTTGC -> TCACTCTTGCG
TTCAGAGAGCT -> TCAGAGAGCTT
TTCATACCTGA -> TCATACCTGAC
TTCATACTGGA -> TCATACTGGAT
TTCATCCTCTA -> TCATCCTCTAT
TTCATGGGAAG -> TCATGGGAAGT
TTCCAGATCTA -> TCCAGATCTAG
TTCCCAGTTAA -> TCCCAGTTAAG
TTCCGATTCGG -> TCCGATTCGGA
TTCCGCACAAA -> TCCGCACAAAT
TTCCGGAGCCT -> TCCGGAGCCTT
TTCCTGCTGAG -> TCCTGCTGAGC
TTCCTTTCATC -> TCCTTTCATCC
TTCGAAGGTTA -> TCGAAGGTTAT
TTCGAAGTAGG -> TCGAAGTAGGT
TTCGATCGTGG -> TCGATCGTGGG
TTCGCCGCAAA -> TCGCCGCAAAC
TTCGGAATAGT -> TCGGAATAGTT
TTCGGATACAT -> TCGGATACATT
TTCGGCTATAC -> TCGGCTATACC
TTCGGGACAGG -> TCGGGACAGGG
TTCGGGCGCAT -> TCGGGCGCATG
TTCGTTGTTAA -> TCGTTGTTAAT
TTCTACCTTTC -> TCTACCTTTCT
TTCTACGTGGC -> TCTACGTGGCC
TTCTATATGCG -> TCTATATGCGT
TTCTATTGCAT -> TCTATTGCATA
TTCTCGGCGAT -> TCTCGGCGATG
TTCTGGCGCAA -> TCTGGCGCAAC
TTCTTCGGATA -> TCTTCGGATAC
TTCTTGTAATT -> TCTTGTAATTT
TTCTTTATCCC -> TCTTTATCCCA
TTGAAACATAT -> TGAAACATATG
TTGAACCGCCA -> TGAACCGCCAT
TTGAAGTTCAA -> TGAAGTTCAAA
TTGACACTAAG -> TGACACTAAGA
TTGACATCGTG -> TGACATCGTGT
TTGAGTCAGCC -> TGAGTCAGCCC
TTGATATCACA -> TGATATCACAG
TTGATGTAGGC -> TGATGTAGGCG
TTGCAGATACG -> TGCAGATACGA
TTGCATAAGCC -> TGCATAAGCCG
TTGCATAGCCC -> TGCATAGCCCT
TTGCCAGGTGC -> TGCCAGGTGCC
TTGCCGCGCTA -> TGCCGCGCTAG
TTGCGGCAATG -> TGCGGCAATGA
TTGCGGGAAGC -> TGCGGGAAGCT
TTGCTCCGAAC -> TGCTCCGAACA
TTGGATTGGTG -> TGGATTGGTGG
TTGGCCACGCC -> TGGCCACGCCG
TTGGGAGGATC -> TGGGAGGATCT
TTGGTAACAAA -> TGGTAACAAAC
TTGGTGGTCAT -> TGGTGGTCATC
TTGTAAGGAAG -> TGTAAGGAAGG
TTGTAATTTAC -> TGTAATTTACG
TTGTACAGACG -> TGTACAGACGG
TTGTATTGGCC -> TGTATTGGCCA
TTGTCATCCTA -> TGTCATCCTAC
TTGTCTGCACA -> TGTCTGCACAC
TTGTGCAGCGG -> TGTGCAGCGGG
TTGTGCGCAAG -> TGTGCGCAAGA
TTGTTAATTCT -> TGTTAATTCTA
TTGTTACACGG -> TGTTACACGGC
TTTAATCACCC -> TTAATCACCCA
TTTACAGTAGG -> TTACAGTAGGG
TTTACGCCAGT -> TTACGCCAGTT
TTTAGTCATGG -> TTAGTCATGGT
TTTATCCCAGC -> TTATCCCAGCA
TTTATGTGACT -> TTATGTGACTT
TTTCACTCTTG -> TTCACTCTTGC
TTTCATCCTCT -> TTCATCCTCTA
TTTCCCAGTTA -> TTCCCAGTTAA
TTTCCGCACAA -> TTCCGCACAAA
TTTCCGGAGCC -> TTCCGGAGCCT
TTTCGAAGTAG -> TTCGAAGTAGG
TTTCTACCTTT -> TTCTACCTTTC
TTTCTTCGGAT -> TTCTTCGGATA
TTTCTTTATCC -> TTCTTTATCCC
TTTGAAACATA -> TTGAAACATAT
TTTGAAGTTCA -> TTGAAGTTCAA
TTTGATATCAC -> TTGATATCACA
TTTGATGTAGG -> TTGATGTAGGC
TTTGCCGCGCT -> TTGCCGCGCTA
TTTGCGGCAAT -> TTGCGGCAATG
TTTGGGAGGAT -> TTGGGAGGATC
TTTTACAGTAG -> TTTACAGTAGG
TTTTAGTCATG -> TTTAGTCATGG
TTTTATGTGAC -> TTTATGTGACT
TTTTGATGTAG -> TTTGATGTAGG
TTTTTACAGTA -> TTTTACAGTAG
TTTTTGATGTA -> TTTTGATGTAG
TTTTTTGATGT -> TTTTTGATGTA
