AAAAAATGTGGCCCAACAC -> AAAAATGTGGCCCAACACT
AAAAAATGTGGCCCAACGC -> AAAAATGTGGCCCAACGCA
AAAAAATGTGGCCCAACGG -> AAAAATGTGGCCCAACGGG
AAAAAATGTGGCCCAACTG -> AAAAATGTGGCCCAACTGT
AAAAACGAGGATCACGGGC -> AAAACGAGGATCACGGGCC
AAAAACGAGTCACGGGTTT -> AAAACGAGTCACGGGTTTC
AAAAAGGCGACCTCAGCTG -> AAAAGGCGACCTCAGCTGA
AAAAATAATTCATCGCCCC -> AAAATAATTCATCGCCCCC
AAAAATGTGGCCCAACACT -> AAAATGTGGCCCAACACTG
AAAAATGTGGCCCAACGCA -> AAAATGTGGCCCAACGCAG
AAAAATGTGGCCCAACGGG -> AAAATGTGGCCCAACGGGA
AAAAATGTGGCCCAACTGT -> AAAATGTGGCCCAACTGTC
AAAACGAGGATCACGGGCC -> AAACGAGGATCACGGGCCA
AAAACGAGTCACGGGTTTC -> AAACGAGTCACGGGTTTCG
AAAAGGCGACCTCAGCTGA -> AAAGGCGACCTCAGCTGAG
AAAAGTAACGTTGCTGTCA -> AAAGTAACGTTGCTGTCAT
AAAATAATTCATCGCCCCC -> AAATAATTCATCGCCCCCA
AAAATCTGCGCGACCTATT -> AAATCTGCGCGACCTATTG
AAAATGTGGCCCAACACTG -> AAATGTGGCCCAACACTGC
AAAATGTGGCCCAACGCAG -> AAATGTGGCCCAACGCAGC
AAAATGTGGCCCAACGGGA -> AAATGTGGCCCAACGGGAC
AAAATGTGGCCCAACTGTC -> AAATGTGGCCCAACTGTCT
AAAATTTTTACTAGCGATG -> AAATTTTTACTAGCGATGG
AAACAGCACGGGGCTAGGA -> AACAGCACGGGGCTAGGAG
AAACCAGAGAGTAACTCCC -> AACCAGAGAGTAACTCCCC
AAACGACTACGTGCATCGA -> AACGACTACGTGCATCGAG
AAACGAGGATCACGGGCCA -> AACGAGGATCACGGGCCAT
AAACGAGTCACGGGTTTCG -> AACGAGTCACGGGTTTCGA
AAACGATAAACGACTACGT -> AACGATAAACGACTACGTG
AAACTACGAGCAAGACCCG -> AACTACGAGCAAGACCCGA
AAACTGTTCACATCCCATC -> AACTGTTCACATCCCATCC
AAAGCAAATTGACTTCTTC -> AAGCAAATTGACTTCTTCC
AAAGCCACTTCCACACTTA -> AAGCCACTTCCACACTTAT
AAAGGCGACCTCAGCTGAG -> AAGGCGACCTCAGCTGAGG
AAAGGGTCAGCCATCTGCG -> AAGGGTCAGCCATCTGCGC
AAAGTAACGTTGCTGTCAT -> AAGTAACGTTGCTGTCATA
AAAGTCATCTATGCTGCCT -> AAGTCATCTATGCTGCCTC
AAATAATTCATCGCCCCCA -> AATAATTCATCGCCCCCAG
AAATCAAGAGGAGTGCGTA -> AATCAAGAGGAGTGCGTAA
AAATCTGCGCGACCTATTG -> AATCTGCGCGACCTATTGG
AAATGGCGGAACACGGTTC -> AATGGCGGAACACGGTTCC
AAATGTATATACCGCCTCG -> AATGTATATACCGCCTCGA
AAATGTGGCCCAACACTGC -> AATGTGGCCCAACACTGCT
AAATGTGGCCCAACGCAGC -> AATGTGGCCCAACGCAGCC
AAATGTGGCCCAACGGGAC -> AATGTGGCCCAACGGGACA
AAATGTGGCCCAACTGTCT -> AATGTGGCCCAACTGTCTA
AAATTAAACAGCACGGGGC -> AATTAAACAGCACGGGGCT
AAATTAAGGTTCCTAGACT -> AATTAAGGTTCCTAGACTT
AAATTAGTGGGGGGATCTG -> AATTAGTGGGGGGATCTGC
AAATTGACTTCTTCCAACC -> AATTGACTTCTTCCAACCT
AAATTGTAAGGCTATCTTG -> AATTGTAAGGCTATCTTGA
AAATTTACCGGTGCTGGAG -> AATTTACCGGTGCTGGAGC
AAATTTTTACTAGCGATGG -> AATTTTTACTAGCGATGGG
AACACGACAAGGGACATGA -> ACACGACAAGGGACATGAG
AACACGGTTCCTCCGTTAT -> ACACGGTTCCTCCGTTATC
AACACTATCCCGGATGGAG -> ACACTATCCCGGATGGAGT
AACACTGCTGTAATGAAAT -> ACACTGCTGTAATGAAATG
AACAGCACGGGGCTAGGAG -> ACAGCACGGGGCTAGGAGG
AACAGCGCTTACCTTAGGG -> ACAGCGCTTACCTTAGGGC
AACAGTGAGAGGGCAGCAC -> ACAGTGAGAGGGCAGCACT
AACCAGAGAGTAACTCCCC -> ACCAGAGAGTAACTCCCCT
AACCTCCGCGTATCGTACG -> ACCTCCGCGTATCGTACGA
AACCTCGGCGGCCCTTAGC -> ACCTCGGCGGCCCTTAGCA
AACGAAGGCGGATGTCTTA -> ACGAAGGCGGATGTCTTAT
AACGACTACGTGCATCGAG -> ACGACTACGTGCATCGAGA
AACGAGGATCACGGGCCAT -> ACGAGGATCACGGGCCATT
AACGAGTCACGGGTTTCGA -> ACGAGTCACGGGTTTCGAT
AACGATAAACGACTACGTG -> ACGATAAACGACTACGTGC
AACGCAGCCTCATCGGACT -> ACGCAGCCTCATCGGACTT
AACGGGACATGAGCTTTAC -> ACGGGACATGAGCTTTACC
AACGGGTTTGAATTGCATG -> ACGGGTTTGAATTGCATGG
AACGGTCCCACCGTACGAG -> ACGGTCCCACCGTACGAGA
AACGTTCGTTTAGGCTAAA -> ACGTTCGTTTAGGCTAAAG
AACGTTGCTGTCATATTTA -> ACGTTGCTGTCATATTTAC
AACTAAAAAATGTGGCCCA -> ACTAAAAAATGTGGCCCAA
AACTACCTAGGCTGGGTCA -> ACTACCTAGGCTGGGTCAC
AACTACGAGCAAGACCCGA -> ACTACGAGCAAGACCCGAG
AACTCACTAGTAGCTCAAC -> ACTCACTAGTAGCTCAACA
AACTCCCCTGCTTGGATGT -> ACTCCCCTGCTTGGATGTG
AACTCTAAGGAAACGATAA -> ACTCTAAGGAAACGATAAA
AACTCTGGCCTTGCTCACG -> ACTCTGGCCTTGCTCACGA
AACTGTCTACCACACGGGC -> ACTGTCTACCACACGGGCG
AACTGTTCACATCCCATCC -> ACTGTTCACATCCCATCCC
AACTGTTCTGCGTCTGTAC -> ACTGTTCTGCGTCTGTACC
AAGACCCGAGATTCATAAT -> AGACCCGAGATTCATAATG
AAGAGGAGTGCGTAACGGT -> AGAGGAGTGCGTAACGGTC
AAGATTTGCATATTCTTGC -> AGATTTGCATATTCTTGCC
AAGCAAATTGACTTCTTCC -> AGCAAATTGACTTCTTCCA
AAGCCACTTCCACACTTAT -> AGCCACTTCCACACTTATT
AAGGAAACGATAAACGACT -> AGGAAACGATAAACGACTA
AAGGCGACCTCAGCTGAGG -> AGGCGACCTCAGCTGAGGC
AAGGCGGATGTCTTATACC -> AGGCGGATGTCTTATACCC
AAGGCTATCTTGATCTGCC -> AGGCTATCTTGATCTGCCA
AAGGGACATGAGTCCGGGA -> AGGGACATGAGTCCGGGAG
AAGGGAGGGCGGCTGCTAA -> AGGGAGGGCGGCTGCTAAC
AAGGGCTCAAAGTCATCTA -> AGGGCTCAAAGTCATCTAT
AAGGGGCGGGTGTTATAAA -> AGGGGCGGGTGTTATAAAT
AAGGGTCAGCCATCTGCGC -> AGGGTCAGCCATCTGCGCT
AAGGTTCCTAGACTTGATA -> AGGTTCCTAGACTTGATAC
AAGTAACGTTGCTGTCATA -> AGTAACGTTGCTGTCATAT
AAGTAGGTCGATGATAATT -> AGTAGGTCGATGATAATTC
AAGTATTCTCAGTGCCAGC -> AGTATTCTCAGTGCCAGCA
AAGTCATCTATGCTGCCTC -> AGTCATCTATGCTGCCTCA
AAGTGGCTTGGCGAGTTAT -> AGTGGCTTGGCGAGTTATA
AAGTGTGCCATTCAATAGA -> AGTGTGCCATTCAATAGAC
AATAATTCATCGCCCCCAG -> ATAATTCATCGCCCCCAGC
AATAGACGGTTCTCTTCAC -> ATAGACGGTTCTCTTCACA
AATAGTAGACTATGGCGAG -> ATAGTAGACTATGGCGAGC
AATCAAGAGGAGTGCGTAA -> ATCAAGAGGAGTGCGTAAC
AATCCCGCACTAGGTTTCC -> ATCCCGCACTAGGTTTCCC
AATCCCTAAAAAATGTGGC -> ATCCCTAAAAAATGTGGCC
AATCTGCGCGACCTATTGG -> ATCTGCGCGACCTATTGGT
AATGAAATGGCGGAACACG -> ATGAAATGGCGGAACACGG
AATGACTTATGGACGGGCT -> ATGACTTATGGACGGGCTG
AATGATCCCAAGGGGCGGG -> ATGATCCCAAGGGGCGGGT
AATGCGAGCTATGTCGAGT -> ATGCGAGCTATGTCGAGTC
AATGCGTACATTGTGCCCC -> ATGCGTACATTGTGCCCCA
AATGCTTCGTGTGCACCCA -> ATGCTTCGTGTGCACCCAT
AATGCTTGCACCCCCAGTT -> ATGCTTGCACCCCCAGTTT
AATGGCGGAACACGGTTCC -> ATGGCGGAACACGGTTCCT
AATGTATATACCGCCTCGA -> ATGTATATACCGCCTCGAC
AATGTGGCCCAACACTGCT -> ATGTGGCCCAACACTGCTG
AATGTGGCCCAACGCAGCC -> ATGTGGCCCAACGCAGCCT
AATGTGGCCCAACGGGACA -> ATGTGGCCCAACGGGACAT
AATGTGGCCCAACTGTCTA -> ATGTGGCCCAACTGTCTAC
AATTAAACAGCACGGGGCT -> ATTAAACAGCACGGGGCTA
AATTAAGGTTCCTAGACTT -> ATTAAGGTTCCTAGACTTG
AATTAGTGGGGGGATCTGC -> ATTAGTGGGGGGATCTGCG
AATTCATCGCCCCCAGCTA -> ATTCATCGCCCCCAGCTAA
AATTCTAAGATTTGCATAT -> ATTCTAAGATTTGCATATT
AATTGACTTCTTCCAACCT -> ATTGACTTCTTCCAACCTC
AATTGCATGGGGTTTGCAG -> ATTGCATGGGGTTTGCAGA
AATTGTAAGGCTATCTTGA -> ATTGTAAGGCTATCTTGAT
AATTTACCGGTGCTGGAGC -> ATTTACCGGTGCTGGAGCT
AATTTGCAGATCCCCCGGA -> ATTTGCAGATCCCCCGGAT
AATTTTTACTAGCGATGGG -> ATTTTTACTAGCGATGGGG
ACAAAAATAATTCATCGCC -> CAAAAATAATTCATCGCCC
ACAAACTGTTCACATCCCA -> CAAACTGTTCACATCCCAT
ACAAATGTATATACCGCCT -> CAAATGTATATACCGCCTC
ACAAGGGACATGAGTCCGG -> CAAGGGACATGAGTCCGGG
ACAAGTAGGTCGATGATAA -> CAAGTAGGTCGATGATAAT
ACAAGTATTCTCAGTGCCA -> CAAGTATTCTCAGTGCCAG
ACACAAAAATAATTCATCG -> CACAAAAATAATTCATCGC
ACACAAGTATTCTCAGTGC -> CACAAGTATTCTCAGTGCC
ACACGACAAGGGACATGAG -> CACGACAAGGGACATGAGT
ACACGGTTCCTCCGTTATC -> CACGGTTCCTCCGTTATCC
ACACTATCCCGGATGGAGT -> CACTATCCCGGATGGAGTA
ACACTGCTGTAATGAAATG -> CACTGCTGTAATGAAATGG
ACACTTATTCGGCGGTATT -> CACTTATTCGGCGGTATTC
ACAGACCGCTGTTGTAGTG -> CAGACCGCTGTTGTAGTGC
ACAGAGTGCCGGAGGCTCG -> CAGAGTGCCGGAGGCTCGC
ACAGCACGGGGCTAGGAGG -> CAGCACGGGGCTAGGAGGG
ACAGCAGGCTTGGGTAGCG -> CAGCAGGCTTGGGTAGCGC
ACAGCGCTTACCTTAGGGC -> CAGCGCTTACCTTAGGGCC
ACAGCTACAGACCGCTGTT -> CAGCTACAGACCGCTGTTG
ACAGTGAGAGGGCAGCACT -> CAGTGAGAGGGCAGCACTG
ACAGTTCACAAATGTATAT -> CAGTTCACAAATGTATATA
ACATACGGGCAAACCAGAG -> CATACGGGCAAACCAGAGA
ACATACGTGTCCGTCACGG -> CATACGTGTCCGTCACGGC
ACATCCCATCCCGACCCGT -> CATCCCATCCCGACCCGTC
ACATCGGGGCGGACGTAGT -> CATCGGGGCGGACGTAGTA
ACATGAGCTTTACCCCTGG -> CATGAGCTTTACCCCTGGA
ACATGAGGTGCGCTGGTCC -> CATGAGGTGCGCTGGTCCT
ACATGAGTCCGGGAGTCAT -> CATGAGTCCGGGAGTCATC
ACATGGATCTTATGGTTGC -> CATGGATCTTATGGTTGCA
ACATTGTGCCCCAATGATC -> CATTGTGCCCCAATGATCC
ACCACTGGAACTCTAAGGA -> CCACTGGAACTCTAAGGAA
ACCAGAGAGTAACTCCCCT -> CCAGAGAGTAACTCCCCTG
ACCCATCCCTTCGGAAGGG -> CCCATCCCTTCGGAAGGGA
ACCCCCAGTTTATGCGAAA -> CCCCCAGTTTATGCGAAAT
ACCCCCTTATGCGCACAAA -> CCCCCTTATGCGCACAAAC
ACCCCTGGACACAAAAATA -> CCCCTGGACACAAAAATAA
ACCCGAGATTCATAATGCT -> CCCGAGATTCATAATGCTT
ACCCGATAGTAACAGCGCT -> CCCGATAGTAACAGCGCTT
ACCCGTCATATGTAGATTC -> CCCGTCATATGTAGATTCC
ACCCTGAGTACTCCTAATA -> CCCTGAGTACTCCTAATAG
ACCGCCTCGACTAAAAACG -> CCGCCTCGACTAAAAACGA
ACCGCGGCGGATACTACCT -> CCGCGGCGGATACTACCTC
ACCGCTGTTGTAGTGCGAG -> CCGCTGTTGTAGTGCGAGA
ACCGGTCGTGCGGATATAA -> CCGGTCGTGCGGATATAAA
ACCGGTGCTGGAGCTCCAG -> CCGGTGCTGGAGCTCCAGA
ACCGTACGAGATTCATGTC -> CCGTACGAGATTCATGTCA
ACCTAAGGGCTCAAAGTCA -> CCTAAGGGCTCAAAGTCAT
ACCTAGGCTGGGTCACTAG -> CCTAGGCTGGGTCACTAGA
ACCTAGTATTTCCAGAGTG -> CCTAGTATTTCCAGAGTGT
ACCTATTGGTGAACTCACT -> CCTATTGGTGAACTCACTA
ACCTCAGCTGAGGCCCCCA -> CCTCAGCTGAGGCCCCCAT
ACCTCCGCGTATCGTACGA -> CCTCCGCGTATCGTACGAC
ACCTCCGTGACTGTCTTGA -> CCTCCGTGACTGTCTTGAG
ACCTCGCGACAGCAGGCTT -> CCTCGCGACAGCAGGCTTG
ACCTCGGCGGCCCTTAGCA -> CCTCGGCGGCCCTTAGCAT
ACCTGCATATCTTGCCTTA -> CCTGCATATCTTGCCTTAA
ACCTTAGGGCCCTGACAGC -> CCTTAGGGCCCTGACAGCT
ACGAAAAAGGCGACCTCAG -> CGAAAAAGGCGACCTCAGC
ACGAAGGCGGATGTCTTAT -> CGAAGGCGGATGTCTTATA
ACGACAAGGGACATGAGTC -> CGACAAGGGACATGAGTCC
ACGACTACGTGCATCGAGA -> CGACTACGTGCATCGAGAA
ACGACTCTGAGGGGGGTTC -> CGACTCTGAGGGGGGTTCA
ACGAGATTCATGTCACCCT -> CGAGATTCATGTCACCCTG
ACGAGCAAGACCCGAGATT -> CGAGCAAGACCCGAGATTC
ACGAGGATCACGGGCCATT -> CGAGGATCACGGGCCATTC
ACGAGTCACGGGTTTCGAT -> CGAGTCACGGGTTTCGATA
ACGATAAACGACTACGTGC -> CGATAAACGACTACGTGCA
ACGCAAATCAAGAGGAGTG -> CGCAAATCAAGAGGAGTGC
ACGCAGCCTCATCGGACTT -> CGCAGCCTCATCGGACTTT
ACGCCCCCTCCAGTCACCT -> CGCCCCCTCCAGTCACCTA
ACGGAAGTGGCTTGGCGAG -> CGGAAGTGGCTTGGCGAGT
ACGGCGGCCAGGGTCAAAT -> CGGCGGCCAGGGTCAAATT
ACGGCGGTCTCTCTTGTAT -> CGGCGGTCTCTCTTGTATT
ACGGGACATGAGCTTTACC -> CGGGACATGAGCTTTACCC
ACGGGCAAACCAGAGAGTA -> CGGGCAAACCAGAGAGTAA
ACGGGCCATTCTGTGGCGC -> CGGGCCATTCTGTGGCGCA
ACGGGCTGACGGAAGTGGC -> CGGGCTGACGGAAGTGGCT
ACGGGGCGTTTTGCAGATC -> CGGGGCGTTTTGCAGATCC
ACGGGGCTAGGAGGGCATT -> CGGGGCTAGGAGGGCATTG
ACGGGTTTCGATAATGCTT -> CGGGTTTCGATAATGCTTG
ACGGGTTTGAATTGCATGG -> CGGGTTTGAATTGCATGGG
ACGGTCCCACCGTACGAGA -> CGGTCCCACCGTACGAGAT
ACGGTTCCTCCGTTATCCG -> CGGTTCCTCCGTTATCCGA
ACGGTTCTCTTCACAGAGT -> CGGTTCTCTTCACAGAGTG
ACGTAGTACCGGTCGTGCG -> CGTAGTACCGGTCGTGCGG
ACGTGCATCGAGAACGTTC -> CGTGCATCGAGAACGTTCG
ACGTGTCCGTCACGGCGGT -> CGTGTCCGTCACGGCGGTC
ACGTTCGTTTAGGCTAAAG -> CGTTCGTTTAGGCTAAAGC
ACGTTGCTGTCATATTTAC -> CGTTGCTGTCATATTTACA
ACTAAAAAATGTGGCCCAA -> CTAAAAAATGTGGCCCAAC
ACTAAAAACGAGTCACGGG -> CTAAAAACGAGTCACGGGT
ACTACCTAGGCTGGGTCAC -> CTACCTAGGCTGGGTCACT
ACTACCTCGCGACAGCAGG -> CTACCTCGCGACAGCAGGC
ACTACGAGCAAGACCCGAG -> CTACGAGCAAGACCCGAGA
ACTACGTGCATCGAGAACG -> CTACGTGCATCGAGAACGT
ACTAGATGGTCTCTAGCTC -> CTAGATGGTCTCTAGCTCC
ACTAGCGATGGGGGACATG -> CTAGCGATGGGGGACATGA
ACTAGGTTTCCCCAGTGGG -> CTAGGTTTCCCCAGTGGGC
ACTAGTAGCTCAACAGTGA -> CTAGTAGCTCAACAGTGAG
ACTATCCCGGATGGAGTAG -> CTATCCCGGATGGAGTAGC
ACTATGGCGAGCGTGAGCG -> CTATGGCGAGCGTGAGCGG
ACTCACTAGTAGCTCAACA -> CTCACTAGTAGCTCAACAG
ACTCCCCGTTCCTGCCTTA -> CTCCCCGTTCCTGCCTTAA
ACTCCCCTGCTTGGATGTG -> CTCCCCTGCTTGGATGTGA
ACTCCTAATAGTAGACTAT -> CTCCTAATAGTAGACTATG
ACTCTAAGGAAACGATAAA -> CTCTAAGGAAACGATAAAC
ACTCTGAGGGGGGTTCACA -> CTCTGAGGGGGGTTCACAT
ACTCTGGCCTTGCTCACGA -> CTCTGGCCTTGCTCACGAA
ACTGATCTCGAATTTGCAG -> CTGATCTCGAATTTGCAGA
ACTGCGATCCAGACGCCCC -> CTGCGATCCAGACGCCCCC
ACTGCTGTAATGAAATGGC -> CTGCTGTAATGAAATGGCG
ACTGGAACTCTAAGGAAAC -> CTGGAACTCTAAGGAAACG
ACTGTCTTGAGTCTGGCTT -> CTGTCTTGAGTCTGGCTTC
ACTGTTCACATCCCATCCC -> CTGTTCACATCCCATCCCG
ACTGTTCTGCGTCTGTACC -> CTGTTCTGCGTCTGTACCT
ACTTATGGACGGGCTGACG -> CTTATGGACGGGCTGACGG
ACTTATTCGGCGGTATTCT -> CTTATTCGGCGGTATTCTT
ACTTCCACACTTATTCGGC -> CTTCCACACTTATTCGGCG
ACTTCCCATAACACTATCC -> CTTCCCATAACACTATCCC
ACTTCTTCCAACCTCGGCG -> CTTCTTCCAACCTCGGCGG
ACTTGATACGCAAATCAAG -> CTTGATACGCAAATCAAGA
ACTTTCGAGCCTAAAAAAT -> CTTTCGAGCCTAAAAAATG
ACTTTGAGTAGGCGGTAGG -> CTTTGAGTAGGCGGTAGGC
AGAAAATTTTTACTAGCGA -> GAAAATTTTTACTAGCGAT
AGAACGTTCGTTTAGGCTA -> GAACGTTCGTTTAGGCTAA
AGACATACGGGCAAACCAG -> GACATACGGGCAAACCAGA
AGACCACTGGAACTCTAAG -> GACCACTGGAACTCTAAGG
AGACCCGAGATTCATAATG -> GACCCGAGATTCATAATGC
AGACCGCTGTTGTAGTGCG -> GACCGCTGTTGTAGTGCGA
AGACGCCCCCTCCAGTCAC -> GACGCCCCCTCCAGTCACC
AGACGGTTCTCTTCACAGA -> GACGGTTCTCTTCACAGAG
AGACTATGGCGAGCGTGAG -> GACTATGGCGAGCGTGAGC
AGACTTGATACGCAAATCA -> GACTTGATACGCAAATCAA
AGAGAGTAACTCCCCTGCT -> GAGAGTAACTCCCCTGCTT
AGAGGAGTGCGTAACGGTC -> GAGGAGTGCGTAACGGTCC
AGAGGGCAGCACTGCGATC -> GAGGGCAGCACTGCGATCC
AGAGTAACTCCCCTGCTTG -> GAGTAACTCCCCTGCTTGG
AGAGTGCCGGAGGCTCGCC -> GAGTGCCGGAGGCTCGCCC
AGAGTGTTCCCTGTGCTCC -> GAGTGTTCCCTGTGCTCCA
AGATCCCCCGGATATCTTT -> GATCCCCCGGATATCTTTA
AGATCCCCCGGATCACTTT -> GATCCCCCGGATCACTTTC
AGATCCCCCGGATGTCCGC -> GATCCCCCGGATGTCCGCC
AGATCCCCCGGATTTTAGT -> GATCCCCCGGATTTTAGTC
AGATCCGCACCTCCGTGAC -> GATCCGCACCTCCGTGACT
AGATGGTCTCTAGCTCCGT -> GATGGTCTCTAGCTCCGTT
AGATTCATAATGCTTCGTG -> GATTCATAATGCTTCGTGT
AGATTCATGTCACCCTGAG -> GATTCATGTCACCCTGAGT
AGATTCCACTGATCTCGAA -> GATTCCACTGATCTCGAAT
AGATTTGCATATTCTTGCC -> GATTTGCATATTCTTGCCA
AGCAAAGGGTCAGCCATCT -> GCAAAGGGTCAGCCATCTG
AGCAAATTGACTTCTTCCA -> GCAAATTGACTTCTTCCAA
AGCAAGACCCGAGATTCAT -> GCAAGACCCGAGATTCATA
AGCAATGCGAGCTATGTCG -> GCAATGCGAGCTATGTCGA
AGCACGGGGCTAGGAGGGC -> GCACGGGGCTAGGAGGGCA
AGCACTGCGATCCAGACGC -> GCACTGCGATCCAGACGCC
AGCAGGCTTGGGTAGCGCG -> GCAGGCTTGGGTAGCGCGT
AGCATACATGGATCTTATG -> GCATACATGGATCTTATGG
AGCATCGTCCTGGTGCGGT -> GCATCGTCCTGGTGCGGTC
AGCCACTTCCACACTTATT -> GCCACTTCCACACTTATTC
AGCCATCTGCGCTTAACCT -> GCCATCTGCGCTTAACCTC
AGCCCGGACAGTTCACAAA -> GCCCGGACAGTTCACAAAT
AGCCTAAAAAATGTGGCCC -> GCCTAAAAAATGTGGCCCA
AGCCTCATCGGACTTTGAG -> GCCTCATCGGACTTTGAGT
AGCGATAACACGACAAGGG -> GCGATAACACGACAAGGGA
AGCGATGGGGGACATGAGG -> GCGATGGGGGACATGAGGT
AGCGCGTCCCGTCACACAA -> GCGCGTCCCGTCACACAAG
AGCGCTAAAAAATGTGGCC -> GCGCTAAAAAATGTGGCCC
AGCGCTTACCTTAGGGCCC -> GCGCTTACCTTAGGGCCCT
AGCGGAGCCCGGACAGTTC -> GCGGAGCCCGGACAGTTCA
AGCGTGAGCGGAGCCCGGA -> GCGTGAGCGGAGCCCGGAC
AGCTAAGTGTGCCATTCAA -> GCTAAGTGTGCCATTCAAT
AGCTACAGACCGCTGTTGT -> GCTACAGACCGCTGTTGTA
AGCTATGTCGAGTCAGTTC -> GCTATGTCGAGTCAGTTCA
AGCTCAACAGTGAGAGGGC -> GCTCAACAGTGAGAGGGCA
AGCTCCAGACCACTGGAAC -> GCTCCAGACCACTGGAACT
AGCTCCGTTTCAACGAAGG -> GCTCCGTTTCAACGAAGGC
AGCTCGGCGTCCGGGATTC -> GCTCGGCGTCCGGGATTCT
AGCTGAGGCCCCCATGGTA -> GCTGAGGCCCCCATGGTAT
AGCTTTACCCCTGGACACA -> GCTTTACCCCTGGACACAA
AGGAAACGATAAACGACTA -> GGAAACGATAAACGACTAC
AGGAGGGCATTGCTTGCTC -> GGAGGGCATTGCTTGCTCT
AGGAGTGCGTAACGGTCCC -> GGAGTGCGTAACGGTCCCA
AGGATCACGGGCCATTCTG -> GGATCACGGGCCATTCTGT
AGGCAATCCCGCACTAGGT -> GGCAATCCCGCACTAGGTT
AGGCACTTCCCATAACACT -> GGCACTTCCCATAACACTA
AGGCAGGCAATCCCGCACT -> GGCAGGCAATCCCGCACTA
AGGCCCCCATGGTATTATT -> GGCCCCCATGGTATTATTT
AGGCGACCTCAGCTGAGGC -> GGCGACCTCAGCTGAGGCC
AGGCGCCAGCAAAGGGTCA -> GGCGCCAGCAAAGGGTCAG
AGGCGGATGTCTTATACCC -> GGCGGATGTCTTATACCCG
AGGCGGTAGGCACTTCCCA -> GGCGGTAGGCACTTCCCAT
AGGCTAAAGCCACTTCCAC -> GGCTAAAGCCACTTCCACA
AGGCTATCTTGATCTGCCA -> GGCTATCTTGATCTGCCAG
AGGCTCGCCCCCTGGTAAA -> GGCTCGCCCCCTGGTAAAA
AGGCTGGGTCACTAGATGG -> GGCTGGGTCACTAGATGGT
AGGCTTGGGTAGCGCGTCC -> GGCTTGGGTAGCGCGTCCC
AGGGACATGAGTCCGGGAG -> GGGACATGAGTCCGGGAGT
AGGGAGGGCGGCTGCTAAC -> GGGAGGGCGGCTGCTAACT
AGGGCAGCACTGCGATCCA -> GGGCAGCACTGCGATCCAG
AGGGCATTGCTTGCTCTCG -> GGGCATTGCTTGCTCTCGA
AGGGCCCTGACAGCTACAG -> GGGCCCTGACAGCTACAGA
AGGGCGGCTGCTAACTGTT -> GGGCGGCTGCTAACTGTTC
AGGGCTCAAAGTCATCTAT -> GGGCTCAAAGTCATCTATG
AGGGGCGGGTGTTATAAAT -> GGGGCGGGTGTTATAAATT
AGGGGGGTTCACATCGGGG -> GGGGGGTTCACATCGGGGC
AGGGTCAAATTTACCGGTG -> GGGTCAAATTTACCGGTGC
AGGGTCAGCCATCTGCGCT -> GGGTCAGCCATCTGCGCTT
AGGTCGATGATAATTCTAA -> GGTCGATGATAATTCTAAG
AGGTGCGCTGGTCCTGTTA -> GGTGCGCTGGTCCTGTTAG
AGGTTCCTAGACTTGATAC -> GGTTCCTAGACTTGATACG
AGGTTTCCAGTGCTGACGG -> GGTTTCCAGTGCTGACGGG
AGGTTTCCCCAGTGGGCAC -> GGTTTCCCCAGTGGGCACC
AGTAACAGCGCTTACCTTA -> GTAACAGCGCTTACCTTAG
AGTAACGTTGCTGTCATAT -> GTAACGTTGCTGTCATATT
AGTAACTCCCCTGCTTGGA -> GTAACTCCCCTGCTTGGAT
AGTAATGACTTATGGACGG -> GTAATGACTTATGGACGGG
AGTACCGGTCGTGCGGATA -> GTACCGGTCGTGCGGATAT
AGTACGGCGGCCAGGGTCA -> GTACGGCGGCCAGGGTCAA
AGTACTCCTAATAGTAGAC -> GTACTCCTAATAGTAGACT
AGTAGACTATGGCGAGCGT -> GTAGACTATGGCGAGCGTG
AGTAGCGATAACACGACAA -> GTAGCGATAACACGACAAG
AGTAGCTCAACAGTGAGAG -> GTAGCTCAACAGTGAGAGG
AGTAGGCGGTAGGCACTTC -> GTAGGCGGTAGGCACTTCC
AGTAGGTCGATGATAATTC -> GTAGGTCGATGATAATTCT
AGTATTCTCAGTGCCAGCA -> GTATTCTCAGTGCCAGCAA
AGTATTTCCAGAGTGTTCC -> GTATTTCCAGAGTGTTCCC
AGTCACCTAGTATTTCCAG -> GTCACCTAGTATTTCCAGA
AGTCACGGGTTTCGATAAT -> GTCACGGGTTTCGATAATG
AGTCAGCGCTAAAAAATGT -> GTCAGCGCTAAAAAATGTG
AGTCAGTTCACTCCCCGTT -> GTCAGTTCACTCCCCGTTC
AGTCATCTATGCTGCCTCA -> GTCATCTATGCTGCCTCAA
AGTCATCTCGCACCTAAGG -> GTCATCTCGCACCTAAGGG
AGTCCGGGAGTCATCTCGC -> GTCCGGGAGTCATCTCGCA
AGTCTGGCTTCAAAATCTG -> GTCTGGCTTCAAAATCTGC
AGTGAGAGGGCAGCACTGC -> GTGAGAGGGCAGCACTGCG
AGTGCCAGCAATGCGAGCT -> GTGCCAGCAATGCGAGCTA
AGTGCCGGAGGCTCGCCCC -> GTGCCGGAGGCTCGCCCCC
AGTGCGAGATCCGCACCTC -> GTGCGAGATCCGCACCTCC
AGTGCGTAACGGTCCCACC -> GTGCGTAACGGTCCCACCG
AGTGCTGACGGGGCGTTTT -> GTGCTGACGGGGCGTTTTG
AGTGGCTTGGCGAGTTATA -> GTGGCTTGGCGAGTTATAG
AGTGGGCACCCCCTTATGC -> GTGGGCACCCCCTTATGCG
AGTGGGGGGATCTGCGGTA -> GTGGGGGGATCTGCGGTAT
AGTGTGCCATTCAATAGAC -> GTGTGCCATTCAATAGACG
AGTGTTCCCTGTGCTCCAC -> GTGTTCCCTGTGCTCCACC
AGTTATAGGCGCCAGCAAA -> GTTATAGGCGCCAGCAAAG
AGTTCACAAATGTATATAC -> GTTCACAAATGTATATACC
AGTTCACTCCCCGTTCCTG -> GTTCACTCCCCGTTCCTGC
AGTTTATGCGAAATTAGTG -> GTTTATGCGAAATTAGTGG
ATAAACGACTACGTGCATC -> TAAACGACTACGTGCATCG
ATAAACTACGAGCAAGACC -> TAAACTACGAGCAAGACCC
ATAAATTAAGGTTCCTAGA -> TAAATTAAGGTTCCTAGAC
ATAACACGACAAGGGACAT -> TAACACGACAAGGGACATG
ATAACACTATCCCGGATGG -> TAACACTATCCCGGATGGA
ATAATGCTTCGTGTGCACC -> TAATGCTTCGTGTGCACCC
ATAATGCTTGCACCCCCAG -> TAATGCTTGCACCCCCAGT
ATAATTCATCGCCCCCAGC -> TAATTCATCGCCCCCAGCT
ATAATTCTAAGATTTGCAT -> TAATTCTAAGATTTGCATA
ATACATGGATCTTATGGTT -> TACATGGATCTTATGGTTG
ATACCCGATAGTAACAGCG -> TACCCGATAGTAACAGCGC
ATACCGCCTCGACTAAAAA -> TACCGCCTCGACTAAAAAC
ATACGCAAATCAAGAGGAG -> TACGCAAATCAAGAGGAGT
ATACGGGCAAACCAGAGAG -> TACGGGCAAACCAGAGAGT
ATACGTGTCCGTCACGGCG -> TACGTGTCCGTCACGGCGG
ATACTACCTCGCGACAGCA -> TACTACCTCGCGACAGCAG
ATAGACGGTTCTCTTCACA -> TAGACGGTTCTCTTCACAG
ATAGGCGCCAGCAAAGGGT -> TAGGCGCCAGCAAAGGGTC
ATAGTAACAGCGCTTACCT -> TAGTAACAGCGCTTACCTT
ATAGTAGACTATGGCGAGC -> TAGTAGACTATGGCGAGCG
ATATAAACTACGAGCAAGA -> TATAAACTACGAGCAAGAC
ATATACCGCCTCGACTAAA -> TATACCGCCTCGACTAAAA
ATATCTTGCCTTAAAAGTA -> TATCTTGCCTTAAAAGTAA
ATATCTTTAATCCCTAAAA -> TATCTTTAATCCCTAAAAA
ATATGTAGATTCCACTGAT -> TATGTAGATTCCACTGATC
ATATTCTTGCCAGAAAATT -> TATTCTTGCCAGAAAATTT
ATATTTACAAGTAGGTCGA -> TATTTACAAGTAGGTCGAT
ATCAAGAGGAGTGCGTAAC -> TCAAGAGGAGTGCGTAACG
ATCACATACGTGTCCGTCA -> TCACATACGTGTCCGTCAC
ATCACGGGCCATTCTGTGG -> TCACGGGCCATTCTGTGGC
ATCACTTTCGAGCCTAAAA -> TCACTTTCGAGCCTAAAAA
ATCCAGACGCCCCCTCCAG -> TCCAGACGCCCCCTCCAGT
ATCCCAAGGGGCGGGTGTT -> TCCCAAGGGGCGGGTGTTA
ATCCCATCCCGACCCGTCA -> TCCCATCCCGACCCGTCAT
ATCCCCCGGATATCTTTAA -> TCCCCCGGATATCTTTAAT
ATCCCCCGGATCACTTTCG -> TCCCCCGGATCACTTTCGA
ATCCCCCGGATGTCCGCCC -> TCCCCCGGATGTCCGCCCT
ATCCCCCGGATTTTAGTCA -> TCCCCCGGATTTTAGTCAG
ATCCCGACCCGTCATATGT -> TCCCGACCCGTCATATGTA
ATCCCGCACTAGGTTTCCC -> TCCCGCACTAGGTTTCCCC
ATCCCGGATGGAGTAGCGA -> TCCCGGATGGAGTAGCGAT
ATCCCTAAAAAATGTGGCC -> TCCCTAAAAAATGTGGCCC
ATCCCTTCGGAAGGGAGGG -> TCCCTTCGGAAGGGAGGGC
ATCCGAGGCAGGCAATCCC -> TCCGAGGCAGGCAATCCCG
ATCCGCACCTCCGTGACTG -> TCCGCACCTCCGTGACTGT
ATCGAGAACGTTCGTTTAG -> TCGAGAACGTTCGTTTAGG
ATCGCCCCCAGCTAAGTGT -> TCGCCCCCAGCTAAGTGTG
ATCGGACTTTGAGTAGGCG -> TCGGACTTTGAGTAGGCGG
ATCGGGGCGGACGTAGTAC -> TCGGGGCGGACGTAGTACC
ATCGTACGACTCTGAGGGG -> TCGTACGACTCTGAGGGGG
ATCGTCCTGGTGCGGTCTG -> TCGTCCTGGTGCGGTCTGG
ATCTATGCAACTACCTAGG -> TCTATGCAACTACCTAGGC
ATCTATGCTGCCTCAACGG -> TCTATGCTGCCTCAACGGG
ATCTCGAATTTGCAGATCC -> TCTCGAATTTGCAGATCCC
ATCTCGCACCTAAGGGCTC -> TCTCGCACCTAAGGGCTCA
ATCTGCCAGTAATGACTTA -> TCTGCCAGTAATGACTTAT
ATCTGCGCGACCTATTGGT -> TCTGCGCGACCTATTGGTG
ATCTGCGCTTAACCTCCGC -> TCTGCGCTTAACCTCCGCG
ATCTGCGGTATCTATGCAA -> TCTGCGGTATCTATGCAAC
ATCTTATGGTTGCATCACA -> TCTTATGGTTGCATCACAT
ATCTTGATCTGCCAGTAAT -> TCTTGATCTGCCAGTAATG
ATCTTGCCTTAAAAGTAAC -> TCTTGCCTTAAAAGTAACG
ATCTTTAATCCCTAAAAAA -> TCTTTAATCCCTAAAAAAT
ATGAAATGGCGGAACACGG -> TGAAATGGCGGAACACGGT
ATGACTTATGGACGGGCTG -> TGACTTATGGACGGGCTGA
ATGAGCTTTACCCCTGGAC -> TGAGCTTTACCCCTGGACA
ATGAGGTGCGCTGGTCCTG -> TGAGGTGCGCTGGTCCTGT
ATGAGTCCGGGAGTCATCT -> TGAGTCCGGGAGTCATCTC
ATGATAATTCTAAGATTTG -> TGATAATTCTAAGATTTGC
ATGATCCCAAGGGGCGGGT -> TGATCCCAAGGGGCGGGTG
ATGCAACTACCTAGGCTGG -> TGCAACTACCTAGGCTGGG
ATGCGAAATTAGTGGGGGG -> TGCGAAATTAGTGGGGGGA
ATGCGAGCTATGTCGAGTC -> TGCGAGCTATGTCGAGTCA
ATGCGCACAAACTGTTCAC -> TGCGCACAAACTGTTCACA
ATGCGTACATTGTGCCCCA -> TGCGTACATTGTGCCCCAA
ATGCTGCCTCAACGGGTTT -> TGCTGCCTCAACGGGTTTG
ATGCTTCGTGTGCACCCAT -> TGCTTCGTGTGCACCCATC
ATGCTTGCACCCCCAGTTT -> TGCTTGCACCCCCAGTTTA
ATGGACGGGCTGACGGAAG -> TGGACGGGCTGACGGAAGT
ATGGAGTAGCGATAACACG -> TGGAGTAGCGATAACACGA
ATGGATCTTATGGTTGCAT -> TGGATCTTATGGTTGCATC
ATGGCGAGCGTGAGCGGAG -> TGGCGAGCGTGAGCGGAGC
ATGGCGGAACACGGTTCCT -> TGGCGGAACACGGTTCCTC
ATGGGGGACATGAGGTGCG -> TGGGGGACATGAGGTGCGC
ATGGGGTTTGCAGATCCCC -> TGGGGTTTGCAGATCCCCC
ATGGGTGTTAGTACGGCGG -> TGGGTGTTAGTACGGCGGC
ATGGTATTATTTCTTAGAC -> TGGTATTATTTCTTAGACA
ATGGTCTCTAGCTCCGTTT -> TGGTCTCTAGCTCCGTTTC
ATGGTTGCATCACATACGT -> TGGTTGCATCACATACGTG
ATGTAGATTCCACTGATCT -> TGTAGATTCCACTGATCTC
ATGTATATACCGCCTCGAC -> TGTATATACCGCCTCGACT
ATGTCACCCTGAGTACTCC -> TGTCACCCTGAGTACTCCT
ATGTCCGCCCTAACTAAAA -> TGTCCGCCCTAACTAAAAA
ATGTCGAGTCAGTTCACTC -> TGTCGAGTCAGTTCACTCC
ATGTCTTATACCCGATAGT -> TGTCTTATACCCGATAGTA
ATGTGATGGGTGTTAGTAC -> TGTGATGGGTGTTAGTACG
ATGTGGCCCAACACTGCTG -> TGTGGCCCAACACTGCTGT
ATGTGGCCCAACGCAGCCT -> TGTGGCCCAACGCAGCCTC
ATGTGGCCCAACGGGACAT -> TGTGGCCCAACGGGACATG
ATGTGGCCCAACTGTCTAC -> TGTGGCCCAACTGTCTACC
ATTAAACAGCACGGGGCTA -> TTAAACAGCACGGGGCTAG
ATTAAGGTTCCTAGACTTG -> TTAAGGTTCCTAGACTTGA
ATTAGTGGGGGGATCTGCG -> TTAGTGGGGGGATCTGCGG
ATTATTTCTTAGACATACG -> TTATTTCTTAGACATACGG
ATTCAATAGACGGTTCTCT -> TTCAATAGACGGTTCTCTT
ATTCATAATGCTTCGTGTG -> TTCATAATGCTTCGTGTGC
ATTCATCGCCCCCAGCTAA -> TTCATCGCCCCCAGCTAAG
ATTCATGTCACCCTGAGTA -> TTCATGTCACCCTGAGTAC
ATTCCACTGATCTCGAATT -> TTCCACTGATCTCGAATTT
ATTCGGCGGTATTCTTAGC -> TTCGGCGGTATTCTTAGCT
ATTCTAAGATTTGCATATT -> TTCTAAGATTTGCATATTC
ATTCTCAGTGCCAGCAATG -> TTCTCAGTGCCAGCAATGC
ATTCTGTGGCGCAATGCGT -> TTCTGTGGCGCAATGCGTA
ATTCTTAGCTCGGCGTCCG -> TTCTTAGCTCGGCGTCCGG
ATTCTTGCCAGAAAATTTT -> TTCTTGCCAGAAAATTTTT
ATTCTTTGCAGATCCCCCG -> TTCTTTGCAGATCCCCCGG
ATTGACTTCTTCCAACCTC -> TTGACTTCTTCCAACCTCG
ATTGCATGGGGTTTGCAGA -> TTGCATGGGGTTTGCAGAT
ATTGCTTGCTCTCGAGGTT -> TTGCTTGCTCTCGAGGTTT
ATTGGTGAACTCACTAGTA -> TTGGTGAACTCACTAGTAG
ATTGTAAGGCTATCTTGAT -> TTGTAAGGCTATCTTGATC
ATTGTGCCCCAATGATCCC -> TTGTGCCCCAATGATCCCA
ATTTACAAGTAGGTCGATG -> TTTACAAGTAGGTCGATGA
ATTTACCGGTGCTGGAGCT -> TTTACCGGTGCTGGAGCTC
ATTTCCAGAGTGTTCCCTG -> TTTCCAGAGTGTTCCCTGT
ATTTCTTAGACATACGGGC -> TTTCTTAGACATACGGGCA
ATTTGCAGATCCCCCGGAT -> TTTGCAGATCCCCCGGATA
ATTTGCATATTCTTGCCAG -> TTTGCATATTCTTGCCAGA
ATTTTAGTCAGCGCTAAAA -> TTTTAGTCAGCGCTAAAAA
ATTTTTACTAGCGATGGGG -> TTTTTACTAGCGATGGGGG
ATTTTTTTGTCAAATTAAA -> TTTTTTTGTCAAATTAAAC
CAAAAATAATTCATCGCCC -> AAAAATAATTCATCGCCCC
CAAAATCTGCGCGACCTAT -> AAAATCTGCGCGACCTATT
CAAACCAGAGAGTAACTCC -> AAACCAGAGAGTAACTCCC
CAAACTGTTCACATCCCAT -> AAACTGTTCACATCCCATC
CAAAGGGTCAGCCATCTGC -> AAAGGGTCAGCCATCTGCG
CAAAGTCATCTATGCTGCC -> AAAGTCATCTATGCTGCCT
CAAATCAAGAGGAGTGCGT -> AAATCAAGAGGAGTGCGTA
CAAATGTATATACCGCCTC -> AAATGTATATACCGCCTCG
CAAATTAAACAGCACGGGG -> AAATTAAACAGCACGGGGC
CAAATTGACTTCTTCCAAC -> AAATTGACTTCTTCCAACC
CAAATTTACCGGTGCTGGA -> AAATTTACCGGTGCTGGAG
CAACACTGCTGTAATGAAA -> AACACTGCTGTAATGAAAT
CAACAGTGAGAGGGCAGCA -> AACAGTGAGAGGGCAGCAC
CAACCTCGGCGGCCCTTAG -> AACCTCGGCGGCCCTTAGC
CAACGAAGGCGGATGTCTT -> AACGAAGGCGGATGTCTTA
CAACGCAGCCTCATCGGAC -> AACGCAGCCTCATCGGACT
CAACGGGACATGAGCTTTA -> AACGGGACATGAGCTTTAC
CAACGGGTTTGAATTGCAT -> AACGGGTTTGAATTGCATG
CAACTACCTAGGCTGGGTC -> AACTACCTAGGCTGGGTCA
CAACTGTCTACCACACGGG -> AACTGTCTACCACACGGGC
CAAGACCCGAGATTCATAA -> AAGACCCGAGATTCATAAT
CAAGAGGAGTGCGTAACGG -> AAGAGGAGTGCGTAACGGT
CAAGGGACATGAGTCCGGG -> AAGGGACATGAGTCCGGGA
CAAGGGGCGGGTGTTATAA -> AAGGGGCGGGTGTTATAAA
CAAGTAGGTCGATGATAAT -> AAGTAGGTCGATGATAATT
CAAGTATTCTCAGTGCCAG -> AAGTATTCTCAGTGCCAGC
CAATAGACGGTTCTCTTCA -> AATAGACGGTTCTCTTCAC
CAATCCCGCACTAGGTTTC -> AATCCCGCACTAGGTTTCC
CAATGATCCCAAGGGGCGG -> AATGATCCCAAGGGGCGGG
CAATGCGAGCTATGTCGAG -> AATGCGAGCTATGTCGAGT
CAATGCGTACATTGTGCCC -> AATGCGTACATTGTGCCCC
CACAAAAATAATTCATCGC -> ACAAAAATAATTCATCGCC
CACAAACTGTTCACATCCC -> ACAAACTGTTCACATCCCA
CACAAATGTATATACCGCC -> ACAAATGTATATACCGCCT
CACAAGTATTCTCAGTGCC -> ACAAGTATTCTCAGTGCCA
CACACAAGTATTCTCAGTG -> ACACAAGTATTCTCAGTGC
CACACTTATTCGGCGGTAT -> ACACTTATTCGGCGGTATT
CACAGAGTGCCGGAGGCTC -> ACAGAGTGCCGGAGGCTCG
CACATACGTGTCCGTCACG -> ACATACGTGTCCGTCACGG
CACATCCCATCCCGACCCG -> ACATCCCATCCCGACCCGT
CACATCGGGGCGGACGTAG -> ACATCGGGGCGGACGTAGT
CACCCATCCCTTCGGAAGG -> ACCCATCCCTTCGGAAGGG
CACCCCCAGTTTATGCGAA -> ACCCCCAGTTTATGCGAAA
CACCCCCTTATGCGCACAA -> ACCCCCTTATGCGCACAAA
CACCCTGAGTACTCCTAAT -> ACCCTGAGTACTCCTAATA
CACCGCGGCGGATACTACC -> ACCGCGGCGGATACTACCT
CACCGTACGAGATTCATGT -> ACCGTACGAGATTCATGTC
CACCTAAGGGCTCAAAGTC -> ACCTAAGGGCTCAAAGTCA
CACCTAGTATTTCCAGAGT -> ACCTAGTATTTCCAGAGTG
CACCTCCGTGACTGTCTTG -> ACCTCCGTGACTGTCTTGA
CACGAAAAAGGCGACCTCA -> ACGAAAAAGGCGACCTCAG
CACGACAAGGGACATGAGT -> ACGACAAGGGACATGAGTC
CACGGCGGTCTCTCTTGTA -> ACGGCGGTCTCTCTTGTAT
CACGGGCCATTCTGTGGCG -> ACGGGCCATTCTGTGGCGC
CACGGGGCTAGGAGGGCAT -> ACGGGGCTAGGAGGGCATT
CACGGGTTTCGATAATGCT -> ACGGGTTTCGATAATGCTT
CACGGTTCCTCCGTTATCC -> ACGGTTCCTCCGTTATCCG
CACTAGATGGTCTCTAGCT -> ACTAGATGGTCTCTAGCTC
CACTAGGTTTCCCCAGTGG -> ACTAGGTTTCCCCAGTGGG
CACTAGTAGCTCAACAGTG -> ACTAGTAGCTCAACAGTGA
CACTATCCCGGATGGAGTA -> ACTATCCCGGATGGAGTAG
CACTCCCCGTTCCTGCCTT -> ACTCCCCGTTCCTGCCTTA
CACTGATCTCGAATTTGCA -> ACTGATCTCGAATTTGCAG
CACTGCGATCCAGACGCCC -> ACTGCGATCCAGACGCCCC
CACTGCTGTAATGAAATGG -> ACTGCTGTAATGAAATGGC
CACTGGAACTCTAAGGAAA -> ACTGGAACTCTAAGGAAAC
CACTTATTCGGCGGTATTC -> ACTTATTCGGCGGTATTCT
CACTTCCACACTTATTCGG -> ACTTCCACACTTATTCGGC
CACTTCCCATAACACTATC -> ACTTCCCATAACACTATCC
CACTTTCGAGCCTAAAAAA -> ACTTTCGAGCCTAAAAAAT
CAGAAAATTTTTACTAGCG -> AGAAAATTTTTACTAGCGA
CAGACCACTGGAACTCTAA -> AGACCACTGGAACTCTAAG
CAGACCGCTGTTGTAGTGC -> AGACCGCTGTTGTAGTGCG
CAGACGCCCCCTCCAGTCA -> AGACGCCCCCTCCAGTCAC
CAGAGAGTAACTCCCCTGC -> AGAGAGTAACTCCCCTGCT
CAGAGTGCCGGAGGCTCGC -> AGAGTGCCGGAGGCTCGCC
CAGAGTGTTCCCTGTGCTC -> AGAGTGTTCCCTGTGCTCC
CAGATCCCCCGGATATCTT -> AGATCCCCCGGATATCTTT
CAGATCCCCCGGATCACTT -> AGATCCCCCGGATCACTTT
CAGATCCCCCGGATGTCCG -> AGATCCCCCGGATGTCCGC
CAGATCCCCCGGATTTTAG -> AGATCCCCCGGATTTTAGT
CAGCAAAGGGTCAGCCATC -> AGCAAAGGGTCAGCCATCT
CAGCAATGCGAGCTATGTC -> AGCAATGCGAGCTATGTCG
CAGCACGGGGCTAGGAGGG -> AGCACGGGGCTAGGAGGGC
CAGCACTGCGATCCAGACG -> AGCACTGCGATCCAGACGC
CAGCAGGCTTGGGTAGCGC -> AGCAGGCTTGGGTAGCGCG
CAGCCATCTGCGCTTAACC -> AGCCATCTGCGCTTAACCT
CAGCCTCATCGGACTTTGA -> AGCCTCATCGGACTTTGAG
CAGCGCTAAAAAATGTGGC -> AGCGCTAAAAAATGTGGCC
CAGCGCTTACCTTAGGGCC -> AGCGCTTACCTTAGGGCCC
CAGCTAAGTGTGCCATTCA -> AGCTAAGTGTGCCATTCAA
CAGCTACAGACCGCTGTTG -> AGCTACAGACCGCTGTTGT
CAGCTGAGGCCCCCATGGT -> AGCTGAGGCCCCCATGGTA
CAGGCAATCCCGCACTAGG -> AGGCAATCCCGCACTAGGT
CAGGCTTGGGTAGCGCGTC -> AGGCTTGGGTAGCGCGTCC
CAGGGTCAAATTTACCGGT -> AGGGTCAAATTTACCGGTG
CAGTAATGACTTATGGACG -> AGTAATGACTTATGGACGG
CAGTCACCTAGTATTTCCA -> AGTCACCTAGTATTTCCAG
CAGTGAGAGGGCAGCACTG -> AGTGAGAGGGCAGCACTGC
CAGTGCCAGCAATGCGAGC -> AGTGCCAGCAATGCGAGCT
CAGTGCTGACGGGGCGTTT -> AGTGCTGACGGGGCGTTTT
CAGTGGGCACCCCCTTATG -> AGTGGGCACCCCCTTATGC
CAGTTCACAAATGTATATA -> AGTTCACAAATGTATATAC
CAGTTCACTCCCCGTTCCT -> AGTTCACTCCCCGTTCCTG
CAGTTTATGCGAAATTAGT -> AGTTTATGCGAAATTAGTG
CATAACACTATCCCGGATG -> ATAACACTATCCCGGATGG
CATAATGCTTCGTGTGCAC -> ATAATGCTTCGTGTGCACC
CATACATGGATCTTATGGT -> ATACATGGATCTTATGGTT
CATACGGGCAAACCAGAGA -> ATACGGGCAAACCAGAGAG
CATACGTGTCCGTCACGGC -> ATACGTGTCCGTCACGGCG
CATATCTTGCCTTAAAAGT -> ATATCTTGCCTTAAAAGTA
CATATGTAGATTCCACTGA -> ATATGTAGATTCCACTGAT
CATATTCTTGCCAGAAAAT -> ATATTCTTGCCAGAAAATT
CATATTTACAAGTAGGTCG -> ATATTTACAAGTAGGTCGA
CATCACATACGTGTCCGTC -> ATCACATACGTGTCCGTCA
CATCCCATCCCGACCCGTC -> ATCCCATCCCGACCCGTCA
CATCCCGACCCGTCATATG -> ATCCCGACCCGTCATATGT
CATCCCTTCGGAAGGGAGG -> ATCCCTTCGGAAGGGAGGG
CATCGAGAACGTTCGTTTA -> ATCGAGAACGTTCGTTTAG
CATCGCCCCCAGCTAAGTG -> ATCGCCCCCAGCTAAGTGT
CATCGGACTTTGAGTAGGC -> ATCGGACTTTGAGTAGGCG
CATCGGGGCGGACGTAGTA -> ATCGGGGCGGACGTAGTAC
CATCGTCCTGGTGCGGTCT -> ATCGTCCTGGTGCGGTCTG
CATCTATGCTGCCTCAACG -> ATCTATGCTGCCTCAACGG
CATCTCGCACCTAAGGGCT -> ATCTCGCACCTAAGGGCTC
CATCTGCGCTTAACCTCCG -> ATCTGCGCTTAACCTCCGC
CATGAGCTTTACCCCTGGA -> ATGAGCTTTACCCCTGGAC
CATGAGGTGCGCTGGTCCT -> ATGAGGTGCGCTGGTCCTG
CATGAGTCCGGGAGTCATC -> ATGAGTCCGGGAGTCATCT
CATGGATCTTATGGTTGCA -> ATGGATCTTATGGTTGCAT
CATGGGGTTTGCAGATCCC -> ATGGGGTTTGCAGATCCCC
CATGGTATTATTTCTTAGA -> ATGGTATTATTTCTTAGAC
CATGTCACCCTGAGTACTC -> ATGTCACCCTGAGTACTCC
CATTCAATAGACGGTTCTC -> ATTCAATAGACGGTTCTCT
CATTCTGTGGCGCAATGCG -> ATTCTGTGGCGCAATGCGT
CATTGCTTGCTCTCGAGGT -> ATTGCTTGCTCTCGAGGTT
CATTGTGCCCCAATGATCC -> ATTGTGCCCCAATGATCCC
CCAACACTGCTGTAATGAA -> CAACACTGCTGTAATGAAA
CCAACCTCGGCGGCCCTTA -> CAACCTCGGCGGCCCTTAG
CCAACGCAGCCTCATCGGA -> CAACGCAGCCTCATCGGAC
CCAACGGGACATGAGCTTT -> CAACGGGACATGAGCTTTA
CCAACTGTCTACCACACGG -> CAACTGTCTACCACACGGG
CCAAGGGGCGGGTGTTATA -> CAAGGGGCGGGTGTTATAA
CCAATGATCCCAAGGGGCG -> CAATGATCCCAAGGGGCGG
CCACACTTATTCGGCGGTA -> CACACTTATTCGGCGGTAT
CCACCGCGGCGGATACTAC -> CACCGCGGCGGATACTACC
CCACCGTACGAGATTCATG -> CACCGTACGAGATTCATGT
CCACTGATCTCGAATTTGC -> CACTGATCTCGAATTTGCA
CCACTGGAACTCTAAGGAA -> CACTGGAACTCTAAGGAAA
CCACTTCCACACTTATTCG -> CACTTCCACACTTATTCGG
CCAGAAAATTTTTACTAGC -> CAGAAAATTTTTACTAGCG
CCAGACCACTGGAACTCTA -> CAGACCACTGGAACTCTAA
CCAGACGCCCCCTCCAGTC -> CAGACGCCCCCTCCAGTCA
CCAGAGAGTAACTCCCCTG -> CAGAGAGTAACTCCCCTGC
CCAGAGTGTTCCCTGTGCT -> CAGAGTGTTCCCTGTGCTC
CCAGCAAAGGGTCAGCCAT -> CAGCAAAGGGTCAGCCATC
CCAGCAATGCGAGCTATGT -> CAGCAATGCGAGCTATGTC
CCAGCTAAGTGTGCCATTC -> CAGCTAAGTGTGCCATTCA
CCAGGGTCAAATTTACCGG -> CAGGGTCAAATTTACCGGT
CCAGTAATGACTTATGGAC -> CAGTAATGACTTATGGACG
CCAGTCACCTAGTATTTCC -> CAGTCACCTAGTATTTCCA
CCAGTGCTGACGGGGCGTT -> CAGTGCTGACGGGGCGTTT
CCAGTGGGCACCCCCTTAT -> CAGTGGGCACCCCCTTATG
CCAGTTTATGCGAAATTAG -> CAGTTTATGCGAAATTAGT
CCATAACACTATCCCGGAT -> CATAACACTATCCCGGATG
CCATCCCGACCCGTCATAT -> CATCCCGACCCGTCATATG
CCATCCCTTCGGAAGGGAG -> CATCCCTTCGGAAGGGAGG
CCATCTGCGCTTAACCTCC -> CATCTGCGCTTAACCTCCG
CCATGGTATTATTTCTTAG -> CATGGTATTATTTCTTAGA
CCATTCAATAGACGGTTCT -> CATTCAATAGACGGTTCTC
CCATTCTGTGGCGCAATGC -> CATTCTGTGGCGCAATGCG
CCCAACACTGCTGTAATGA -> CCAACACTGCTGTAATGAA
CCCAACGCAGCCTCATCGG -> CCAACGCAGCCTCATCGGA
CCCAACGGGACATGAGCTT -> CCAACGGGACATGAGCTTT
CCCAACTGTCTACCACACG -> CCAACTGTCTACCACACGG
CCCAAGGGGCGGGTGTTAT -> CCAAGGGGCGGGTGTTATA
CCCAATGATCCCAAGGGGC -> CCAATGATCCCAAGGGGCG
CCCACCGTACGAGATTCAT -> CCACCGTACGAGATTCATG
CCCAGCTAAGTGTGCCATT -> CCAGCTAAGTGTGCCATTC
CCCAGTGGGCACCCCCTTA -> CCAGTGGGCACCCCCTTAT
CCCAGTTTATGCGAAATTA -> CCAGTTTATGCGAAATTAG
CCCATAACACTATCCCGGA -> CCATAACACTATCCCGGAT
CCCATCCCGACCCGTCATA -> CCATCCCGACCCGTCATAT
CCCATCCCTTCGGAAGGGA -> CCATCCCTTCGGAAGGGAG
CCCATGGTATTATTTCTTA -> CCATGGTATTATTTCTTAG
CCCCAATGATCCCAAGGGG -> CCCAATGATCCCAAGGGGC
CCCCAGCTAAGTGTGCCAT -> CCCAGCTAAGTGTGCCATT
CCCCAGTGGGCACCCCCTT -> CCCAGTGGGCACCCCCTTA
CCCCAGTTTATGCGAAATT -> CCCAGTTTATGCGAAATTA
CCCCATGGTATTATTTCTT -> CCCATGGTATTATTTCTTA
CCCCCAGCTAAGTGTGCCA -> CCCCAGCTAAGTGTGCCAT
CCCCCAGTTTATGCGAAAT -> CCCCAGTTTATGCGAAATT
CCCCCATGGTATTATTTCT -> CCCCATGGTATTATTTCTT
CCCCCGGATATCTTTAATC -> CCCCGGATATCTTTAATCC
CCCCCGGATCACTTTCGAG -> CCCCGGATCACTTTCGAGC
CCCCCGGATGTCCGCCCTA -> CCCCGGATGTCCGCCCTAA
CCCCCGGATTTTAGTCAGC -> CCCCGGATTTTAGTCAGCG
CCCCCTCCAGTCACCTAGT -> CCCCTCCAGTCACCTAGTA
CCCCCTGGTAAAAACGAGG -> CCCCTGGTAAAAACGAGGA
CCCCCTTATGCGCACAAAC -> CCCCTTATGCGCACAAACT
CCCCGGATATCTTTAATCC -> CCCGGATATCTTTAATCCC
CCCCGGATCACTTTCGAGC -> CCCGGATCACTTTCGAGCC
CCCCGGATGTCCGCCCTAA -> CCCGGATGTCCGCCCTAAC
CCCCGGATTTTAGTCAGCG -> CCCGGATTTTAGTCAGCGC
CCCCGTTCCTGCCTTAACT -> CCCGTTCCTGCCTTAACTC
CCCCTCCAGTCACCTAGTA -> CCCTCCAGTCACCTAGTAT
CCCCTGCTTGGATGTGATG -> CCCTGCTTGGATGTGATGG
CCCCTGGACACAAAAATAA -> CCCTGGACACAAAAATAAT
CCCCTGGTAAAAACGAGGA -> CCCTGGTAAAAACGAGGAT
CCCCTTATGCGCACAAACT -> CCCTTATGCGCACAAACTG
CCCGACCCGTCATATGTAG -> CCGACCCGTCATATGTAGA
CCCGAGATTCATAATGCTT -> CCGAGATTCATAATGCTTC
CCCGATAGTAACAGCGCTT -> CCGATAGTAACAGCGCTTA
CCCGCACTAGGTTTCCCCA -> CCGCACTAGGTTTCCCCAG
CCCGGACAGTTCACAAATG -> CCGGACAGTTCACAAATGT
CCCGGATATCTTTAATCCC -> CCGGATATCTTTAATCCCT
CCCGGATCACTTTCGAGCC -> CCGGATCACTTTCGAGCCT
CCCGGATGGAGTAGCGATA -> CCGGATGGAGTAGCGATAA
CCCGGATGTCCGCCCTAAC -> CCGGATGTCCGCCCTAACT
CCCGGATTTTAGTCAGCGC -> CCGGATTTTAGTCAGCGCT
CCCGTCACACAAGTATTCT -> CCGTCACACAAGTATTCTC
CCCGTCATATGTAGATTCC -> CCGTCATATGTAGATTCCA
CCCGTTCCTGCCTTAACTC -> CCGTTCCTGCCTTAACTCT
CCCTAAAAAATGTGGCCCA -> CCTAAAAAATGTGGCCCAA
CCCTAACTAAAAAATGTGG -> CCTAACTAAAAAATGTGGC
CCCTCCAGTCACCTAGTAT -> CCTCCAGTCACCTAGTATT
CCCTGACAGCTACAGACCG -> CCTGACAGCTACAGACCGC
CCCTGAGTACTCCTAATAG -> CCTGAGTACTCCTAATAGT
CCCTGCTTGGATGTGATGG -> CCTGCTTGGATGTGATGGG
CCCTGGACACAAAAATAAT -> CCTGGACACAAAAATAATT
CCCTGGTAAAAACGAGGAT -> CCTGGTAAAAACGAGGATC
CCCTGTGCTCCACCGCGGC -> CCTGTGCTCCACCGCGGCG
CCCTTAGCATCGTCCTGGT -> CCTTAGCATCGTCCTGGTG
CCCTTATGCGCACAAACTG -> CCTTATGCGCACAAACTGT
CCCTTCGGAAGGGAGGGCG -> CCTTCGGAAGGGAGGGCGG
CCGACCCGTCATATGTAGA -> CGACCCGTCATATGTAGAT
CCGAGATTCATAATGCTTC -> CGAGATTCATAATGCTTCG
CCGAGGCAGGCAATCCCGC -> CGAGGCAGGCAATCCCGCA
CCGATAGTAACAGCGCTTA -> CGATAGTAACAGCGCTTAC
CCGCACCTCCGTGACTGTC -> CGCACCTCCGTGACTGTCT
CCGCACTAGGTTTCCCCAG -> CGCACTAGGTTTCCCCAGT
CCGCCCTAACTAAAAAATG -> CGCCCTAACTAAAAAATGT
CCGCCTCGACTAAAAACGA -> CGCCTCGACTAAAAACGAG
CCGCGGCGGATACTACCTC -> CGCGGCGGATACTACCTCG
CCGCGTATCGTACGACTCT -> CGCGTATCGTACGACTCTG
CCGCTGTTGTAGTGCGAGA -> CGCTGTTGTAGTGCGAGAT
CCGGACAGTTCACAAATGT -> CGGACAGTTCACAAATGTA
CCGGAGGCTCGCCCCCTGG -> CGGAGGCTCGCCCCCTGGT
CCGGATATCTTTAATCCCT -> CGGATATCTTTAATCCCTA
CCGGATCACTTTCGAGCCT -> CGGATCACTTTCGAGCCTA
CCGGATGGAGTAGCGATAA -> CGGATGGAGTAGCGATAAC
CCGGATGTCCGCCCTAACT -> CGGATGTCCGCCCTAACTA
CCGGATTTTAGTCAGCGCT -> CGGATTTTAGTCAGCGCTA
CCGGGAGTCATCTCGCACC -> CGGGAGTCATCTCGCACCT
CCGGGATTCTTTGCAGATC -> CGGGATTCTTTGCAGATCC
CCGGTCGTGCGGATATAAA -> CGGTCGTGCGGATATAAAC
CCGGTGCTGGAGCTCCAGA -> CGGTGCTGGAGCTCCAGAC
CCGTACGAGATTCATGTCA -> CGTACGAGATTCATGTCAC
CCGTCACACAAGTATTCTC -> CGTCACACAAGTATTCTCA
CCGTCACGGCGGTCTCTCT -> CGTCACGGCGGTCTCTCTT
CCGTCATATGTAGATTCCA -> CGTCATATGTAGATTCCAC
CCGTGACTGTCTTGAGTCT -> CGTGACTGTCTTGAGTCTG
CCGTTATCCGAGGCAGGCA -> CGTTATCCGAGGCAGGCAA
CCGTTCCTGCCTTAACTCT -> CGTTCCTGCCTTAACTCTG
CCGTTTCAACGAAGGCGGA -> CGTTTCAACGAAGGCGGAT
CCTAAAAAATGTGGCCCAA -> CTAAAAAATGTGGCCCAAC,CTAAAAAATGTGGCCCAAC
CCTAACTAAAAAATGTGGC -> CTAACTAAAAAATGTGGCC
CCTAAGGGCTCAAAGTCAT -> CTAAGGGCTCAAAGTCATC
CCTAATAGTAGACTATGGC -> CTAATAGTAGACTATGGCG
CCTAGACTTGATACGCAAA -> CTAGACTTGATACGCAAAT
CCTAGGCTGGGTCACTAGA -> CTAGGCTGGGTCACTAGAT
CCTAGTATTTCCAGAGTGT -> CTAGTATTTCCAGAGTGTT
CCTATTGGTGAACTCACTA -> CTATTGGTGAACTCACTAG
CCTCAACGGGTTTGAATTG -> CTCAACGGGTTTGAATTGC
CCTCAGCTGAGGCCCCCAT -> CTCAGCTGAGGCCCCCATG
CCTCATCGGACTTTGAGTA -> CTCATCGGACTTTGAGTAG
CCTCCAGTCACCTAGTATT -> CTCCAGTCACCTAGTATTT
CCTCCGCGTATCGTACGAC -> CTCCGCGTATCGTACGACT
CCTCCGTGACTGTCTTGAG -> CTCCGTGACTGTCTTGAGT
CCTCCGTTATCCGAGGCAG -> CTCCGTTATCCGAGGCAGG
CCTCGACTAAAAACGAGTC -> CTCGACTAAAAACGAGTCA
CCTCGCGACAGCAGGCTTG -> CTCGCGACAGCAGGCTTGG
CCTCGGCGGCCCTTAGCAT -> CTCGGCGGCCCTTAGCATC
CCTGACAGCTACAGACCGC -> CTGACAGCTACAGACCGCT
CCTGAGTACTCCTAATAGT -> CTGAGTACTCCTAATAGTA
CCTGCATATCTTGCCTTAA -> CTGCATATCTTGCCTTAAA
CCTGCCTTAACTCTGGCCT -> CTGCCTTAACTCTGGCCTT
CCTGCTTGGATGTGATGGG -> CTGCTTGGATGTGATGGGT
CCTGGACACAAAAATAATT -> CTGGACACAAAAATAATTC
CCTGGTAAAAACGAGGATC -> CTGGTAAAAACGAGGATCA
CCTGGTGCGGTCTGGGAAA -> CTGGTGCGGTCTGGGAAAT
CCTGTGCTCCACCGCGGCG -> CTGTGCTCCACCGCGGCGG
CCTGTTAGCATACATGGAT -> CTGTTAGCATACATGGATC
CCTTAAAAGTAACGTTGCT -> CTTAAAAGTAACGTTGCTG
CCTTAACTCTGGCCTTGCT -> CTTAACTCTGGCCTTGCTC
CCTTAGCATCGTCCTGGTG -> CTTAGCATCGTCCTGGTGC
CCTTAGGGCCCTGACAGCT -> CTTAGGGCCCTGACAGCTA
CCTTATGCGCACAAACTGT -> CTTATGCGCACAAACTGTT
CCTTCGGAAGGGAGGGCGG -> CTTCGGAAGGGAGGGCGGC
CCTTGCTCACGAAAAAGGC -> CTTGCTCACGAAAAAGGCG
CGAAAAAGGCGACCTCAGC -> GAAAAAGGCGACCTCAGCT
CGAAATTAGTGGGGGGATC -> GAAATTAGTGGGGGGATCT
CGAAGGCGGATGTCTTATA -> GAAGGCGGATGTCTTATAC
CGAATTTGCAGATCCCCCG -> GAATTTGCAGATCCCCCGG
CGACAAGGGACATGAGTCC -> GACAAGGGACATGAGTCCG
CGACAGCAGGCTTGGGTAG -> GACAGCAGGCTTGGGTAGC
CGACCCGTCATATGTAGAT -> GACCCGTCATATGTAGATT
CGACCTATTGGTGAACTCA -> GACCTATTGGTGAACTCAC
CGACCTCAGCTGAGGCCCC -> GACCTCAGCTGAGGCCCCC
CGACTAAAAACGAGTCACG -> GACTAAAAACGAGTCACGG
CGACTACGTGCATCGAGAA -> GACTACGTGCATCGAGAAC
CGACTCTGAGGGGGGTTCA -> GACTCTGAGGGGGGTTCAC
CGAGAACGTTCGTTTAGGC -> GAGAACGTTCGTTTAGGCT
CGAGATCCGCACCTCCGTG -> GAGATCCGCACCTCCGTGA
CGAGATTCATAATGCTTCG -> GAGATTCATAATGCTTCGT
CGAGATTCATGTCACCCTG -> GAGATTCATGTCACCCTGA
CGAGCAAGACCCGAGATTC -> GAGCAAGACCCGAGATTCA
CGAGCCTAAAAAATGTGGC -> GAGCCTAAAAAATGTGGCC
CGAGCGTGAGCGGAGCCCG -> GAGCGTGAGCGGAGCCCGG
CGAGCTATGTCGAGTCAGT -> GAGCTATGTCGAGTCAGTT
CGAGGATCACGGGCCATTC -> GAGGATCACGGGCCATTCT
CGAGGCAGGCAATCCCGCA -> GAGGCAGGCAATCCCGCAC
CGAGGTTTCCAGTGCTGAC -> GAGGTTTCCAGTGCTGACG
CGAGTCACGGGTTTCGATA -> GAGTCACGGGTTTCGATAA
CGAGTCAGTTCACTCCCCG -> GAGTCAGTTCACTCCCCGT
CGAGTTATAGGCGCCAGCA -> GAGTTATAGGCGCCAGCAA
CGATAAACGACTACGTGCA -> GATAAACGACTACGTGCAT
CGATAACACGACAAGGGAC -> GATAACACGACAAGGGACA
CGATAATGCTTGCACCCCC -> GATAATGCTTGCACCCCCA
CGATAGTAACAGCGCTTAC -> GATAGTAACAGCGCTTACC
CGATCCAGACGCCCCCTCC -> GATCCAGACGCCCCCTCCA
CGATGATAATTCTAAGATT -> GATGATAATTCTAAGATTT
CGATGGGGGACATGAGGTG -> GATGGGGGACATGAGGTGC
CGCAAATCAAGAGGAGTGC -> GCAAATCAAGAGGAGTGCG
CGCAATGCGTACATTGTGC -> GCAATGCGTACATTGTGCC
CGCACAAACTGTTCACATC -> GCACAAACTGTTCACATCC
CGCACCTAAGGGCTCAAAG -> GCACCTAAGGGCTCAAAGT
CGCACCTCCGTGACTGTCT -> GCACCTCCGTGACTGTCTT
CGCACTAGGTTTCCCCAGT -> GCACTAGGTTTCCCCAGTG
CGCAGCCTCATCGGACTTT -> GCAGCCTCATCGGACTTTG
CGCCAGCAAAGGGTCAGCC -> GCCAGCAAAGGGTCAGCCA
CGCCCCCAGCTAAGTGTGC -> GCCCCCAGCTAAGTGTGCC
CGCCCCCTCCAGTCACCTA -> GCCCCCTCCAGTCACCTAG
CGCCCCCTGGTAAAAACGA -> GCCCCCTGGTAAAAACGAG
CGCCCTAACTAAAAAATGT -> GCCCTAACTAAAAAATGTG
CGCCTCGACTAAAAACGAG -> GCCTCGACTAAAAACGAGT
CGCGACAGCAGGCTTGGGT -> GCGACAGCAGGCTTGGGTA
CGCGACCTATTGGTGAACT -> GCGACCTATTGGTGAACTC
CGCGGCGGATACTACCTCG -> GCGGCGGATACTACCTCGC
CGCGTATCGTACGACTCTG -> GCGTATCGTACGACTCTGA
CGCGTCCCGTCACACAAGT -> GCGTCCCGTCACACAAGTA
CGCTAAAAAATGTGGCCCA -> GCTAAAAAATGTGGCCCAA
CGCTGGTCCTGTTAGCATA -> GCTGGTCCTGTTAGCATAC
CGCTGTTGTAGTGCGAGAT -> GCTGTTGTAGTGCGAGATC
CGCTTAACCTCCGCGTATC -> GCTTAACCTCCGCGTATCG
CGCTTACCTTAGGGCCCTG -> GCTTACCTTAGGGCCCTGA
CGGAACACGGTTCCTCCGT -> GGAACACGGTTCCTCCGTT
CGGAAGGGAGGGCGGCTGC -> GGAAGGGAGGGCGGCTGCT
CGGAAGTGGCTTGGCGAGT -> GGAAGTGGCTTGGCGAGTT
CGGACAGTTCACAAATGTA -> GGACAGTTCACAAATGTAT
CGGACGTAGTACCGGTCGT -> GGACGTAGTACCGGTCGTG
CGGACTTTGAGTAGGCGGT -> GGACTTTGAGTAGGCGGTA
CGGAGCCCGGACAGTTCAC -> GGAGCCCGGACAGTTCACA
CGGAGGCTCGCCCCCTGGT -> GGAGGCTCGCCCCCTGGTA
CGGATACTACCTCGCGACA -> GGATACTACCTCGCGACAG
CGGATATAAACTACGAGCA -> GGATATAAACTACGAGCAA
CGGATATCTTTAATCCCTA -> GGATATCTTTAATCCCTAA
CGGATCACTTTCGAGCCTA -> GGATCACTTTCGAGCCTAA
CGGATGGAGTAGCGATAAC -> GGATGGAGTAGCGATAACA
CGGATGTCCGCCCTAACTA -> GGATGTCCGCCCTAACTAA
CGGATGTCTTATACCCGAT -> GGATGTCTTATACCCGATA
CGGATTTTAGTCAGCGCTA -> GGATTTTAGTCAGCGCTAA
CGGCCAGGGTCAAATTTAC -> GGCCAGGGTCAAATTTACC
CGGCCCTTAGCATCGTCCT -> GGCCCTTAGCATCGTCCTG
CGGCGGATACTACCTCGCG -> GGCGGATACTACCTCGCGA
CGGCGGCCAGGGTCAAATT -> GGCGGCCAGGGTCAAATTT
CGGCGGCCCTTAGCATCGT -> GGCGGCCCTTAGCATCGTC
CGGCGGTATTCTTAGCTCG -> GGCGGTATTCTTAGCTCGG
CGGCGGTCTCTCTTGTATT -> GGCGGTCTCTCTTGTATTT
CGGCGTCCGGGATTCTTTG -> GGCGTCCGGGATTCTTTGC
CGGCTGCTAACTGTTCTGC -> GGCTGCTAACTGTTCTGCG
CGGGACATGAGCTTTACCC -> GGGACATGAGCTTTACCCC
CGGGAGTCATCTCGCACCT -> GGGAGTCATCTCGCACCTA
CGGGATTCTTTGCAGATCC -> GGGATTCTTTGCAGATCCC
CGGGCAAACCAGAGAGTAA -> GGGCAAACCAGAGAGTAAC
CGGGCCATTCTGTGGCGCA -> GGGCCATTCTGTGGCGCAA
CGGGCTGACGGAAGTGGCT -> GGGCTGACGGAAGTGGCTT
CGGGGCGGACGTAGTACCG -> GGGGCGGACGTAGTACCGG
CGGGGCGTTTTGCAGATCC -> GGGGCGTTTTGCAGATCCC
CGGGGCTAGGAGGGCATTG -> GGGGCTAGGAGGGCATTGC
CGGGTGTTATAAATTAAGG -> GGGTGTTATAAATTAAGGT
CGGGTTTCGATAATGCTTG -> GGGTTTCGATAATGCTTGC
CGGGTTTGAATTGCATGGG -> GGGTTTGAATTGCATGGGG
CGGTAGGCACTTCCCATAA -> GGTAGGCACTTCCCATAAC
CGGTATCTATGCAACTACC -> GGTATCTATGCAACTACCT
CGGTATTCTTAGCTCGGCG -> GGTATTCTTAGCTCGGCGT
CGGTCCCACCGTACGAGAT -> GGTCCCACCGTACGAGATT
CGGTCGTGCGGATATAAAC -> GGTCGTGCGGATATAAACT
CGGTCTCTCTTGTATTTTT -> GGTCTCTCTTGTATTTTTT
CGGTCTGGGAAATTGTAAG -> GGTCTGGGAAATTGTAAGG
CGGTGCTGGAGCTCCAGAC -> GGTGCTGGAGCTCCAGACC
CGGTTCCTCCGTTATCCGA -> GGTTCCTCCGTTATCCGAG
CGGTTCTCTTCACAGAGTG -> GGTTCTCTTCACAGAGTGC
CGTAACGGTCCCACCGTAC -> GTAACGGTCCCACCGTACG
CGTACATTGTGCCCCAATG -> GTACATTGTGCCCCAATGA
CGTACGACTCTGAGGGGGG -> GTACGACTCTGAGGGGGGT
CGTACGAGATTCATGTCAC -> GTACGAGATTCATGTCACC
CGTAGTACCGGTCGTGCGG -> GTAGTACCGGTCGTGCGGA
CGTATCGTACGACTCTGAG -> GTATCGTACGACTCTGAGG
CGTCACACAAGTATTCTCA -> GTCACACAAGTATTCTCAG
CGTCACGGCGGTCTCTCTT -> GTCACGGCGGTCTCTCTTG
CGTCATATGTAGATTCCAC -> GTCATATGTAGATTCCACT
CGTCCCGTCACACAAGTAT -> GTCCCGTCACACAAGTATT
CGTCCGGGATTCTTTGCAG -> GTCCGGGATTCTTTGCAGA
CGTCCTGGTGCGGTCTGGG -> GTCCTGGTGCGGTCTGGGA
CGTCTGTACCTGCATATCT -> GTCTGTACCTGCATATCTT
CGTGACTGTCTTGAGTCTG -> GTGACTGTCTTGAGTCTGG
CGTGAGCGGAGCCCGGACA -> GTGAGCGGAGCCCGGACAG
CGTGCATCGAGAACGTTCG -> GTGCATCGAGAACGTTCGT
CGTGCGGATATAAACTACG -> GTGCGGATATAAACTACGA
CGTGTCCGTCACGGCGGTC -> GTGTCCGTCACGGCGGTCT
CGTGTGCACCCATCCCTTC -> GTGTGCACCCATCCCTTCG
CGTTATCCGAGGCAGGCAA -> GTTATCCGAGGCAGGCAAT
CGTTCCTGCCTTAACTCTG -> GTTCCTGCCTTAACTCTGG
CGTTCGTTTAGGCTAAAGC -> GTTCGTTTAGGCTAAAGCC
CGTTGCTGTCATATTTACA -> GTTGCTGTCATATTTACAA
CGTTTAGGCTAAAGCCACT -> GTTTAGGCTAAAGCCACTT
CGTTTCAACGAAGGCGGAT -> GTTTCAACGAAGGCGGATG
CGTTTTGCAGATCCCCCGG -> GTTTTGCAGATCCCCCGGA
CTAAAAAATGTGGCCCAAC -> TAAAAAATGTGGCCCAACT,TAAAAAATGTGGCCCAACA,TAAAAAATGTGGCCCAACG,TAAAAAATGTGGCCCAACG
CTAAAAACGAGTCACGGGT -> TAAAAACGAGTCACGGGTT
CTAAAGCCACTTCCACACT -> TAAAGCCACTTCCACACTT
CTAACTAAAAAATGTGGCC -> TAACTAAAAAATGTGGCCC
CTAACTGTTCTGCGTCTGT -> TAACTGTTCTGCGTCTGTA
CTAAGATTTGCATATTCTT -> TAAGATTTGCATATTCTTG
CTAAGGAAACGATAAACGA -> TAAGGAAACGATAAACGAC
CTAAGGGCTCAAAGTCATC -> TAAGGGCTCAAAGTCATCT
CTAAGTGTGCCATTCAATA -> TAAGTGTGCCATTCAATAG
CTAATAGTAGACTATGGCG -> TAATAGTAGACTATGGCGA
CTACAGACCGCTGTTGTAG -> TACAGACCGCTGTTGTAGT
CTACCTAGGCTGGGTCACT -> TACCTAGGCTGGGTCACTA
CTACCTCGCGACAGCAGGC -> TACCTCGCGACAGCAGGCT
CTACGAGCAAGACCCGAGA -> TACGAGCAAGACCCGAGAT
CTACGTGCATCGAGAACGT -> TACGTGCATCGAGAACGTT
CTAGACTTGATACGCAAAT -> TAGACTTGATACGCAAATC
CTAGATGGTCTCTAGCTCC -> TAGATGGTCTCTAGCTCCG
CTAGCGATGGGGGACATGA -> TAGCGATGGGGGACATGAG
CTAGCTCCGTTTCAACGAA -> TAGCTCCGTTTCAACGAAG
CTAGGAGGGCATTGCTTGC -> TAGGAGGGCATTGCTTGCT
CTAGGCTGGGTCACTAGAT -> TAGGCTGGGTCACTAGATG
CTAGGTTTCCCCAGTGGGC -> TAGGTTTCCCCAGTGGGCA
CTAGTAGCTCAACAGTGAG -> TAGTAGCTCAACAGTGAGA
CTAGTATTTCCAGAGTGTT -> TAGTATTTCCAGAGTGTTC
CTATCCCGGATGGAGTAGC -> TATCCCGGATGGAGTAGCG
CTATCTTGATCTGCCAGTA -> TATCTTGATCTGCCAGTAA
CTATGCAACTACCTAGGCT -> TATGCAACTACCTAGGCTG
CTATGCTGCCTCAACGGGT -> TATGCTGCCTCAACGGGTT
CTATGGCGAGCGTGAGCGG -> TATGGCGAGCGTGAGCGGA
CTATGTCGAGTCAGTTCAC -> TATGTCGAGTCAGTTCACT
CTATTGGTGAACTCACTAG -> TATTGGTGAACTCACTAGT
CTCAAAGTCATCTATGCTG -> TCAAAGTCATCTATGCTGC
CTCAACAGTGAGAGGGCAG -> TCAACAGTGAGAGGGCAGC
CTCAACGGGTTTGAATTGC -> TCAACGGGTTTGAATTGCA
CTCACGAAAAAGGCGACCT -> TCACGAAAAAGGCGACCTC
CTCACTAGTAGCTCAACAG -> TCACTAGTAGCTCAACAGT
CTCAGCTGAGGCCCCCATG -> TCAGCTGAGGCCCCCATGG
CTCAGTGCCAGCAATGCGA -> TCAGTGCCAGCAATGCGAG
CTCATCGGACTTTGAGTAG -> TCATCGGACTTTGAGTAGG
CTCCACCGCGGCGGATACT -> TCCACCGCGGCGGATACTA
CTCCAGACCACTGGAACTC -> TCCAGACCACTGGAACTCT
CTCCAGTCACCTAGTATTT -> TCCAGTCACCTAGTATTTC
CTCCCCGTTCCTGCCTTAA -> TCCCCGTTCCTGCCTTAAC
CTCCCCTGCTTGGATGTGA -> TCCCCTGCTTGGATGTGAT
CTCCGCGTATCGTACGACT -> TCCGCGTATCGTACGACTC
CTCCGTGACTGTCTTGAGT -> TCCGTGACTGTCTTGAGTC
CTCCGTTATCCGAGGCAGG -> TCCGTTATCCGAGGCAGGC
CTCCGTTTCAACGAAGGCG -> TCCGTTTCAACGAAGGCGG
CTCCTAATAGTAGACTATG -> TCCTAATAGTAGACTATGG
CTCGAATTTGCAGATCCCC -> TCGAATTTGCAGATCCCCC
CTCGACTAAAAACGAGTCA -> TCGACTAAAAACGAGTCAC
CTCGAGGTTTCCAGTGCTG -> TCGAGGTTTCCAGTGCTGA
CTCGCACCTAAGGGCTCAA -> TCGCACCTAAGGGCTCAAA
CTCGCCCCCTGGTAAAAAC -> TCGCCCCCTGGTAAAAACG
CTCGCGACAGCAGGCTTGG -> TCGCGACAGCAGGCTTGGG
CTCGGCGGCCCTTAGCATC -> TCGGCGGCCCTTAGCATCG
CTCGGCGTCCGGGATTCTT -> TCGGCGTCCGGGATTCTTT
CTCTAAGGAAACGATAAAC -> TCTAAGGAAACGATAAACG
CTCTAGCTCCGTTTCAACG -> TCTAGCTCCGTTTCAACGA
CTCTCGAGGTTTCCAGTGC -> TCTCGAGGTTTCCAGTGCT
CTCTCTTGTATTTTTTTGT -> TCTCTTGTATTTTTTTGTC
CTCTGAGGGGGGTTCACAT -> TCTGAGGGGGGTTCACATC
CTCTGGCCTTGCTCACGAA -> TCTGGCCTTGCTCACGAAA
CTCTTCACAGAGTGCCGGA -> TCTTCACAGAGTGCCGGAG
CTCTTGTATTTTTTTGTCA -> TCTTGTATTTTTTTGTCAA
CTGACAGCTACAGACCGCT -> TGACAGCTACAGACCGCTG
CTGACGGAAGTGGCTTGGC -> TGACGGAAGTGGCTTGGCG
CTGACGGGGCGTTTTGCAG -> TGACGGGGCGTTTTGCAGA
CTGAGGCCCCCATGGTATT -> TGAGGCCCCCATGGTATTA
CTGAGGGGGGTTCACATCG -> TGAGGGGGGTTCACATCGG
CTGAGTACTCCTAATAGTA -> TGAGTACTCCTAATAGTAG
CTGATCTCGAATTTGCAGA -> TGATCTCGAATTTGCAGAT
CTGCATATCTTGCCTTAAA -> TGCATATCTTGCCTTAAAA
CTGCCAGTAATGACTTATG -> TGCCAGTAATGACTTATGG
CTGCCTCAACGGGTTTGAA -> TGCCTCAACGGGTTTGAAT
CTGCCTTAACTCTGGCCTT -> TGCCTTAACTCTGGCCTTG
CTGCGATCCAGACGCCCCC -> TGCGATCCAGACGCCCCCT
CTGCGCGACCTATTGGTGA -> TGCGCGACCTATTGGTGAA
CTGCGCTTAACCTCCGCGT -> TGCGCTTAACCTCCGCGTA
CTGCGGTATCTATGCAACT -> TGCGGTATCTATGCAACTA
CTGCGTCTGTACCTGCATA -> TGCGTCTGTACCTGCATAT
CTGCTAACTGTTCTGCGTC -> TGCTAACTGTTCTGCGTCT
CTGCTGTAATGAAATGGCG -> TGCTGTAATGAAATGGCGG
CTGCTTGGATGTGATGGGT -> TGCTTGGATGTGATGGGTG
CTGGAACTCTAAGGAAACG -> TGGAACTCTAAGGAAACGA
CTGGACACAAAAATAATTC -> TGGACACAAAAATAATTCA
CTGGAGCTCCAGACCACTG -> TGGAGCTCCAGACCACTGG
CTGGCCTTGCTCACGAAAA -> TGGCCTTGCTCACGAAAAA
CTGGCTTCAAAATCTGCGC -> TGGCTTCAAAATCTGCGCG
CTGGGAAAGCAAATTGACT -> TGGGAAAGCAAATTGACTT
CTGGGAAATTGTAAGGCTA -> TGGGAAATTGTAAGGCTAT
CTGGGTCACTAGATGGTCT -> TGGGTCACTAGATGGTCTC
CTGGTAAAAACGAGGATCA -> TGGTAAAAACGAGGATCAC
CTGGTCCTGTTAGCATACA -> TGGTCCTGTTAGCATACAT
CTGGTGCGGTCTGGGAAAT -> TGGTGCGGTCTGGGAAATT
CTGTAATGAAATGGCGGAA -> TGTAATGAAATGGCGGAAC
CTGTACCTGCATATCTTGC -> TGTACCTGCATATCTTGCC
CTGTCATATTTACAAGTAG -> TGTCATATTTACAAGTAGG
CTGTCTTGAGTCTGGCTTC -> TGTCTTGAGTCTGGCTTCA
CTGTGCTCCACCGCGGCGG -> TGTGCTCCACCGCGGCGGA
CTGTGGCGCAATGCGTACA -> TGTGGCGCAATGCGTACAT
CTGTTAGCATACATGGATC -> TGTTAGCATACATGGATCT
CTGTTCACATCCCATCCCG -> TGTTCACATCCCATCCCGA
CTGTTCTGCGTCTGTACCT -> TGTTCTGCGTCTGTACCTG
CTGTTGTAGTGCGAGATCC -> TGTTGTAGTGCGAGATCCG
CTTAAAAGTAACGTTGCTG -> TTAAAAGTAACGTTGCTGT
CTTAACCTCCGCGTATCGT -> TTAACCTCCGCGTATCGTA
CTTAACTCTGGCCTTGCTC -> TTAACTCTGGCCTTGCTCA
CTTACCTTAGGGCCCTGAC -> TTACCTTAGGGCCCTGACA
CTTAGACATACGGGCAAAC -> TTAGACATACGGGCAAACC
CTTAGCATCGTCCTGGTGC -> TTAGCATCGTCCTGGTGCG
CTTAGCTCGGCGTCCGGGA -> TTAGCTCGGCGTCCGGGAT
CTTAGGGCCCTGACAGCTA -> TTAGGGCCCTGACAGCTAC
CTTATACCCGATAGTAACA -> TTATACCCGATAGTAACAG
CTTATGCGCACAAACTGTT -> TTATGCGCACAAACTGTTC
CTTATGGACGGGCTGACGG -> TTATGGACGGGCTGACGGA
CTTATGGTTGCATCACATA -> TTATGGTTGCATCACATAC
CTTATTCGGCGGTATTCTT -> TTATTCGGCGGTATTCTTA
CTTCAAAATCTGCGCGACC -> TTCAAAATCTGCGCGACCT
CTTCACAGAGTGCCGGAGG -> TTCACAGAGTGCCGGAGGC
CTTCCAACCTCGGCGGCCC -> TTCCAACCTCGGCGGCCCT
CTTCCACACTTATTCGGCG -> TTCCACACTTATTCGGCGG
CTTCCCATAACACTATCCC -> TTCCCATAACACTATCCCG
CTTCGGAAGGGAGGGCGGC -> TTCGGAAGGGAGGGCGGCT
CTTCGTGTGCACCCATCCC -> TTCGTGTGCACCCATCCCT
CTTCTTCCAACCTCGGCGG -> TTCTTCCAACCTCGGCGGC
CTTGAGTCTGGCTTCAAAA -> TTGAGTCTGGCTTCAAAAT
CTTGATACGCAAATCAAGA -> TTGATACGCAAATCAAGAG
CTTGATCTGCCAGTAATGA -> TTGATCTGCCAGTAATGAC
CTTGCACCCCCAGTTTATG -> TTGCACCCCCAGTTTATGC
CTTGCCAGAAAATTTTTAC -> TTGCCAGAAAATTTTTACT
CTTGCCTTAAAAGTAACGT -> TTGCCTTAAAAGTAACGTT
CTTGCTCACGAAAAAGGCG -> TTGCTCACGAAAAAGGCGA
CTTGCTCTCGAGGTTTCCA -> TTGCTCTCGAGGTTTCCAG
CTTGGATGTGATGGGTGTT -> TTGGATGTGATGGGTGTTA
CTTGGCGAGTTATAGGCGC -> TTGGCGAGTTATAGGCGCC
CTTGGGTAGCGCGTCCCGT -> TTGGGTAGCGCGTCCCGTC
CTTGTATTTTTTTGTCAAA -> TTGTATTTTTTTGTCAAAT
CTTTAATCCCTAAAAAATG -> TTTAATCCCTAAAAAATGT
CTTTACCCCTGGACACAAA -> TTTACCCCTGGACACAAAA
CTTTCGAGCCTAAAAAATG -> TTTCGAGCCTAAAAAATGT
CTTTGAGTAGGCGGTAGGC -> TTTGAGTAGGCGGTAGGCA
CTTTGCAGATCCCCCGGAT -> TTTGCAGATCCCCCGGATC
GAAAAAGGCGACCTCAGCT -> AAAAAGGCGACCTCAGCTG
GAAAATTTTTACTAGCGAT -> AAAATTTTTACTAGCGATG
GAAACGATAAACGACTACG -> AAACGATAAACGACTACGT
GAAAGCAAATTGACTTCTT -> AAAGCAAATTGACTTCTTC
GAAATGGCGGAACACGGTT -> AAATGGCGGAACACGGTTC
GAAATTAGTGGGGGGATCT -> AAATTAGTGGGGGGATCTG
GAAATTGTAAGGCTATCTT -> AAATTGTAAGGCTATCTTG
GAACACGGTTCCTCCGTTA -> AACACGGTTCCTCCGTTAT
GAACGTTCGTTTAGGCTAA -> AACGTTCGTTTAGGCTAAA
GAACTCACTAGTAGCTCAA -> AACTCACTAGTAGCTCAAC
GAACTCTAAGGAAACGATA -> AACTCTAAGGAAACGATAA
GAAGGCGGATGTCTTATAC -> AAGGCGGATGTCTTATACC
GAAGGGAGGGCGGCTGCTA -> AAGGGAGGGCGGCTGCTAA
GAAGTGGCTTGGCGAGTTA -> AAGTGGCTTGGCGAGTTAT
GAATTGCATGGGGTTTGCA -> AATTGCATGGGGTTTGCAG
GAATTTGCAGATCCCCCGG -> AATTTGCAGATCCCCCGGA
GACAAGGGACATGAGTCCG -> ACAAGGGACATGAGTCCGG
GACACAAAAATAATTCATC -> ACACAAAAATAATTCATCG
GACAGCAGGCTTGGGTAGC -> ACAGCAGGCTTGGGTAGCG
GACAGCTACAGACCGCTGT -> ACAGCTACAGACCGCTGTT
GACAGTTCACAAATGTATA -> ACAGTTCACAAATGTATAT
GACATACGGGCAAACCAGA -> ACATACGGGCAAACCAGAG
GACATGAGCTTTACCCCTG -> ACATGAGCTTTACCCCTGG
GACATGAGGTGCGCTGGTC -> ACATGAGGTGCGCTGGTCC
GACATGAGTCCGGGAGTCA -> ACATGAGTCCGGGAGTCAT
GACCACTGGAACTCTAAGG -> ACCACTGGAACTCTAAGGA
GACCCGAGATTCATAATGC -> ACCCGAGATTCATAATGCT
GACCCGTCATATGTAGATT -> ACCCGTCATATGTAGATTC
GACCGCTGTTGTAGTGCGA -> ACCGCTGTTGTAGTGCGAG
GACCTATTGGTGAACTCAC -> ACCTATTGGTGAACTCACT
GACCTCAGCTGAGGCCCCC -> ACCTCAGCTGAGGCCCCCA
GACGCCCCCTCCAGTCACC -> ACGCCCCCTCCAGTCACCT
GACGGAAGTGGCTTGGCGA -> ACGGAAGTGGCTTGGCGAG
GACGGGCTGACGGAAGTGG -> ACGGGCTGACGGAAGTGGC
GACGGGGCGTTTTGCAGAT -> ACGGGGCGTTTTGCAGATC
GACGGTTCTCTTCACAGAG -> ACGGTTCTCTTCACAGAGT
GACGTAGTACCGGTCGTGC -> ACGTAGTACCGGTCGTGCG
GACTAAAAACGAGTCACGG -> ACTAAAAACGAGTCACGGG
GACTACGTGCATCGAGAAC -> ACTACGTGCATCGAGAACG
GACTATGGCGAGCGTGAGC -> ACTATGGCGAGCGTGAGCG
GACTCTGAGGGGGGTTCAC -> ACTCTGAGGGGGGTTCACA
GACTGTCTTGAGTCTGGCT -> ACTGTCTTGAGTCTGGCTT
GACTTATGGACGGGCTGAC -> ACTTATGGACGGGCTGACG
GACTTCTTCCAACCTCGGC -> ACTTCTTCCAACCTCGGCG
GACTTGATACGCAAATCAA -> ACTTGATACGCAAATCAAG
GACTTTGAGTAGGCGGTAG -> ACTTTGAGTAGGCGGTAGG
GAGAACGTTCGTTTAGGCT -> AGAACGTTCGTTTAGGCTA
GAGAGGGCAGCACTGCGAT -> AGAGGGCAGCACTGCGATC
GAGAGTAACTCCCCTGCTT -> AGAGTAACTCCCCTGCTTG
GAGATCCGCACCTCCGTGA -> AGATCCGCACCTCCGTGAC
GAGATTCATAATGCTTCGT -> AGATTCATAATGCTTCGTG
GAGATTCATGTCACCCTGA -> AGATTCATGTCACCCTGAG
GAGCAAGACCCGAGATTCA -> AGCAAGACCCGAGATTCAT
GAGCCCGGACAGTTCACAA -> AGCCCGGACAGTTCACAAA
GAGCCTAAAAAATGTGGCC -> AGCCTAAAAAATGTGGCCC
GAGCGGAGCCCGGACAGTT -> AGCGGAGCCCGGACAGTTC
GAGCGTGAGCGGAGCCCGG -> AGCGTGAGCGGAGCCCGGA
GAGCTATGTCGAGTCAGTT -> AGCTATGTCGAGTCAGTTC
GAGCTCCAGACCACTGGAA -> AGCTCCAGACCACTGGAAC
GAGCTTTACCCCTGGACAC -> AGCTTTACCCCTGGACACA
GAGGAGTGCGTAACGGTCC -> AGGAGTGCGTAACGGTCCC
GAGGATCACGGGCCATTCT -> AGGATCACGGGCCATTCTG
GAGGCAGGCAATCCCGCAC -> AGGCAGGCAATCCCGCACT
GAGGCCCCCATGGTATTAT -> AGGCCCCCATGGTATTATT
GAGGCTCGCCCCCTGGTAA -> AGGCTCGCCCCCTGGTAAA
GAGGGCAGCACTGCGATCC -> AGGGCAGCACTGCGATCCA
GAGGGCATTGCTTGCTCTC -> AGGGCATTGCTTGCTCTCG
GAGGGCGGCTGCTAACTGT -> AGGGCGGCTGCTAACTGTT
GAGGGGGGTTCACATCGGG -> AGGGGGGTTCACATCGGGG
GAGGTGCGCTGGTCCTGTT -> AGGTGCGCTGGTCCTGTTA
GAGGTTTCCAGTGCTGACG -> AGGTTTCCAGTGCTGACGG
GAGTAACTCCCCTGCTTGG -> AGTAACTCCCCTGCTTGGA
GAGTACTCCTAATAGTAGA -> AGTACTCCTAATAGTAGAC
GAGTAGCGATAACACGACA -> AGTAGCGATAACACGACAA
GAGTAGGCGGTAGGCACTT -> AGTAGGCGGTAGGCACTTC
GAGTCACGGGTTTCGATAA -> AGTCACGGGTTTCGATAAT
GAGTCAGTTCACTCCCCGT -> AGTCAGTTCACTCCCCGTT
GAGTCATCTCGCACCTAAG -> AGTCATCTCGCACCTAAGG
GAGTCCGGGAGTCATCTCG -> AGTCCGGGAGTCATCTCGC
GAGTCTGGCTTCAAAATCT -> AGTCTGGCTTCAAAATCTG
GAGTGCCGGAGGCTCGCCC -> AGTGCCGGAGGCTCGCCCC
GAGTGCGTAACGGTCCCAC -> AGTGCGTAACGGTCCCACC
GAGTGTTCCCTGTGCTCCA -> AGTGTTCCCTGTGCTCCAC
GAGTTATAGGCGCCAGCAA -> AGTTATAGGCGCCAGCAAA
GATAAACGACTACGTGCAT -> ATAAACGACTACGTGCATC
GATAACACGACAAGGGACA -> ATAACACGACAAGGGACAT
GATAATGCTTGCACCCCCA -> ATAATGCTTGCACCCCCAG
GATAATTCTAAGATTTGCA -> ATAATTCTAAGATTTGCAT
GATACGCAAATCAAGAGGA -> ATACGCAAATCAAGAGGAG
GATACTACCTCGCGACAGC -> ATACTACCTCGCGACAGCA
GATAGTAACAGCGCTTACC -> ATAGTAACAGCGCTTACCT
GATATAAACTACGAGCAAG -> ATATAAACTACGAGCAAGA
GATATCTTTAATCCCTAAA -> ATATCTTTAATCCCTAAAA
GATCACGGGCCATTCTGTG -> ATCACGGGCCATTCTGTGG
GATCACTTTCGAGCCTAAA -> ATCACTTTCGAGCCTAAAA
GATCCAGACGCCCCCTCCA -> ATCCAGACGCCCCCTCCAG
GATCCCAAGGGGCGGGTGT -> ATCCCAAGGGGCGGGTGTT
GATCCCCCGGATATCTTTA -> ATCCCCCGGATATCTTTAA
GATCCCCCGGATCACTTTC -> ATCCCCCGGATCACTTTCG
GATCCCCCGGATGTCCGCC -> ATCCCCCGGATGTCCGCCC
GATCCCCCGGATTTTAGTC -> ATCCCCCGGATTTTAGTCA
GATCCGCACCTCCGTGACT -> ATCCGCACCTCCGTGACTG
GATCTCGAATTTGCAGATC -> ATCTCGAATTTGCAGATCC
GATCTGCCAGTAATGACTT -> ATCTGCCAGTAATGACTTA
GATCTGCGGTATCTATGCA -> ATCTGCGGTATCTATGCAA
GATCTTATGGTTGCATCAC -> ATCTTATGGTTGCATCACA
GATGATAATTCTAAGATTT -> ATGATAATTCTAAGATTTG
GATGGAGTAGCGATAACAC -> ATGGAGTAGCGATAACACG
GATGGGGGACATGAGGTGC -> ATGGGGGACATGAGGTGCG
GATGGGTGTTAGTACGGCG -> ATGGGTGTTAGTACGGCGG
GATGGTCTCTAGCTCCGTT -> ATGGTCTCTAGCTCCGTTT
GATGTCCGCCCTAACTAAA -> ATGTCCGCCCTAACTAAAA
GATGTCTTATACCCGATAG -> ATGTCTTATACCCGATAGT
GATGTGATGGGTGTTAGTA -> ATGTGATGGGTGTTAGTAC
GATTCATAATGCTTCGTGT -> ATTCATAATGCTTCGTGTG
GATTCATGTCACCCTGAGT -> ATTCATGTCACCCTGAGTA
GATTCCACTGATCTCGAAT -> ATTCCACTGATCTCGAATT
GATTCTTTGCAGATCCCCC -> ATTCTTTGCAGATCCCCCG
GATTTGCATATTCTTGCCA -> ATTTGCATATTCTTGCCAG
GATTTTAGTCAGCGCTAAA -> ATTTTAGTCAGCGCTAAAA
GCAAACCAGAGAGTAACTC -> CAAACCAGAGAGTAACTCC
GCAAAGGGTCAGCCATCTG -> CAAAGGGTCAGCCATCTGC
GCAAATCAAGAGGAGTGCG -> CAAATCAAGAGGAGTGCGT
GCAAATTGACTTCTTCCAA -> CAAATTGACTTCTTCCAAC
GCAACTACCTAGGCTGGGT -> CAACTACCTAGGCTGGGTC
GCAAGACCCGAGATTCATA -> CAAGACCCGAGATTCATAA
GCAATCCCGCACTAGGTTT -> CAATCCCGCACTAGGTTTC
GCAATGCGAGCTATGTCGA -> CAATGCGAGCTATGTCGAG
GCAATGCGTACATTGTGCC -> CAATGCGTACATTGTGCCC
GCACAAACTGTTCACATCC -> CACAAACTGTTCACATCCC
GCACCCATCCCTTCGGAAG -> CACCCATCCCTTCGGAAGG
GCACCCCCAGTTTATGCGA -> CACCCCCAGTTTATGCGAA
GCACCCCCTTATGCGCACA -> CACCCCCTTATGCGCACAA
GCACCTAAGGGCTCAAAGT -> CACCTAAGGGCTCAAAGTC
GCACCTCCGTGACTGTCTT -> CACCTCCGTGACTGTCTTG
GCACGGGGCTAGGAGGGCA -> CACGGGGCTAGGAGGGCAT
GCACTAGGTTTCCCCAGTG -> CACTAGGTTTCCCCAGTGG
GCACTGCGATCCAGACGCC -> CACTGCGATCCAGACGCCC
GCACTTCCCATAACACTAT -> CACTTCCCATAACACTATC
GCAGATCCCCCGGATATCT -> CAGATCCCCCGGATATCTT
GCAGATCCCCCGGATCACT -> CAGATCCCCCGGATCACTT
GCAGATCCCCCGGATGTCC -> CAGATCCCCCGGATGTCCG
GCAGATCCCCCGGATTTTA -> CAGATCCCCCGGATTTTAG
GCAGCACTGCGATCCAGAC -> CAGCACTGCGATCCAGACG
GCAGCCTCATCGGACTTTG -> CAGCCTCATCGGACTTTGA
GCAGGCAATCCCGCACTAG -> CAGGCAATCCCGCACTAGG
GCAGGCTTGGGTAGCGCGT -> CAGGCTTGGGTAGCGCGTC
GCATACATGGATCTTATGG -> CATACATGGATCTTATGGT
GCATATCTTGCCTTAAAAG -> CATATCTTGCCTTAAAAGT
GCATATTCTTGCCAGAAAA -> CATATTCTTGCCAGAAAAT
GCATCACATACGTGTCCGT -> CATCACATACGTGTCCGTC
GCATCGAGAACGTTCGTTT -> CATCGAGAACGTTCGTTTA
GCATCGTCCTGGTGCGGTC -> CATCGTCCTGGTGCGGTCT
GCATGGGGTTTGCAGATCC -> CATGGGGTTTGCAGATCCC
GCATTGCTTGCTCTCGAGG -> CATTGCTTGCTCTCGAGGT
GCCACTTCCACACTTATTC -> CCACTTCCACACTTATTCG
GCCAGAAAATTTTTACTAG -> CCAGAAAATTTTTACTAGC
GCCAGCAAAGGGTCAGCCA -> CCAGCAAAGGGTCAGCCAT
GCCAGCAATGCGAGCTATG -> CCAGCAATGCGAGCTATGT
GCCAGGGTCAAATTTACCG -> CCAGGGTCAAATTTACCGG
GCCAGTAATGACTTATGGA -> CCAGTAATGACTTATGGAC
GCCATCTGCGCTTAACCTC -> CCATCTGCGCTTAACCTCC
GCCATTCAATAGACGGTTC -> CCATTCAATAGACGGTTCT
GCCATTCTGTGGCGCAATG -> CCATTCTGTGGCGCAATGC
GCCCAACACTGCTGTAATG -> CCCAACACTGCTGTAATGA
GCCCAACGCAGCCTCATCG -> CCCAACGCAGCCTCATCGG
GCCCAACGGGACATGAGCT -> CCCAACGGGACATGAGCTT
GCCCAACTGTCTACCACAC -> CCCAACTGTCTACCACACG
GCCCCAATGATCCCAAGGG -> CCCCAATGATCCCAAGGGG
GCCCCCAGCTAAGTGTGCC -> CCCCCAGCTAAGTGTGCCA
GCCCCCATGGTATTATTTC -> CCCCCATGGTATTATTTCT
GCCCCCTCCAGTCACCTAG -> CCCCCTCCAGTCACCTAGT
GCCCCCTGGTAAAAACGAG -> CCCCCTGGTAAAAACGAGG
GCCCGGACAGTTCACAAAT -> CCCGGACAGTTCACAAATG
GCCCTAACTAAAAAATGTG -> CCCTAACTAAAAAATGTGG
GCCCTGACAGCTACAGACC -> CCCTGACAGCTACAGACCG
GCCCTTAGCATCGTCCTGG -> CCCTTAGCATCGTCCTGGT
GCCGGAGGCTCGCCCCCTG -> CCGGAGGCTCGCCCCCTGG
GCCTAAAAAATGTGGCCCA -> CCTAAAAAATGTGGCCCAA
GCCTCAACGGGTTTGAATT -> CCTCAACGGGTTTGAATTG
GCCTCATCGGACTTTGAGT -> CCTCATCGGACTTTGAGTA
GCCTCGACTAAAAACGAGT -> CCTCGACTAAAAACGAGTC
GCCTTAAAAGTAACGTTGC -> CCTTAAAAGTAACGTTGCT
GCCTTAACTCTGGCCTTGC -> CCTTAACTCTGGCCTTGCT
GCCTTGCTCACGAAAAAGG -> CCTTGCTCACGAAAAAGGC
GCGAAATTAGTGGGGGGAT -> CGAAATTAGTGGGGGGATC
GCGACAGCAGGCTTGGGTA -> CGACAGCAGGCTTGGGTAG
GCGACCTATTGGTGAACTC -> CGACCTATTGGTGAACTCA
GCGACCTCAGCTGAGGCCC -> CGACCTCAGCTGAGGCCCC
GCGAGATCCGCACCTCCGT -> CGAGATCCGCACCTCCGTG
GCGAGCGTGAGCGGAGCCC -> CGAGCGTGAGCGGAGCCCG
GCGAGCTATGTCGAGTCAG -> CGAGCTATGTCGAGTCAGT
GCGAGTTATAGGCGCCAGC -> CGAGTTATAGGCGCCAGCA
GCGATAACACGACAAGGGA -> CGATAACACGACAAGGGAC
GCGATCCAGACGCCCCCTC -> CGATCCAGACGCCCCCTCC
GCGATGGGGGACATGAGGT -> CGATGGGGGACATGAGGTG
GCGCAATGCGTACATTGTG -> CGCAATGCGTACATTGTGC
GCGCACAAACTGTTCACAT -> CGCACAAACTGTTCACATC
GCGCCAGCAAAGGGTCAGC -> CGCCAGCAAAGGGTCAGCC
GCGCGACCTATTGGTGAAC -> CGCGACCTATTGGTGAACT
GCGCGTCCCGTCACACAAG -> CGCGTCCCGTCACACAAGT
GCGCTAAAAAATGTGGCCC -> CGCTAAAAAATGTGGCCCA
GCGCTGGTCCTGTTAGCAT -> CGCTGGTCCTGTTAGCATA
GCGCTTAACCTCCGCGTAT -> CGCTTAACCTCCGCGTATC
GCGCTTACCTTAGGGCCCT -> CGCTTACCTTAGGGCCCTG
GCGGAACACGGTTCCTCCG -> CGGAACACGGTTCCTCCGT
GCGGACGTAGTACCGGTCG -> CGGACGTAGTACCGGTCGT
GCGGAGCCCGGACAGTTCA -> CGGAGCCCGGACAGTTCAC
GCGGATACTACCTCGCGAC -> CGGATACTACCTCGCGACA
GCGGATATAAACTACGAGC -> CGGATATAAACTACGAGCA
GCGGATGTCTTATACCCGA -> CGGATGTCTTATACCCGAT
GCGGCCAGGGTCAAATTTA -> CGGCCAGGGTCAAATTTAC
GCGGCCCTTAGCATCGTCC -> CGGCCCTTAGCATCGTCCT
GCGGCGGATACTACCTCGC -> CGGCGGATACTACCTCGCG
GCGGCTGCTAACTGTTCTG -> CGGCTGCTAACTGTTCTGC
GCGGGTGTTATAAATTAAG -> CGGGTGTTATAAATTAAGG
GCGGTAGGCACTTCCCATA -> CGGTAGGCACTTCCCATAA
GCGGTATCTATGCAACTAC -> CGGTATCTATGCAACTACC
GCGGTATTCTTAGCTCGGC -> CGGTATTCTTAGCTCGGCG
GCGGTCTCTCTTGTATTTT -> CGGTCTCTCTTGTATTTTT
GCGGTCTGGGAAATTGTAA -> CGGTCTGGGAAATTGTAAG
GCGTAACGGTCCCACCGTA -> CGTAACGGTCCCACCGTAC
GCGTACATTGTGCCCCAAT -> CGTACATTGTGCCCCAATG
GCGTATCGTACGACTCTGA -> CGTATCGTACGACTCTGAG
GCGTCCCGTCACACAAGTA -> CGTCCCGTCACACAAGTAT
GCGTCCGGGATTCTTTGCA -> CGTCCGGGATTCTTTGCAG
GCGTCTGTACCTGCATATC -> CGTCTGTACCTGCATATCT
GCGTGAGCGGAGCCCGGAC -> CGTGAGCGGAGCCCGGACA
GCGTTTTGCAGATCCCCCG -> CGTTTTGCAGATCCCCCGG
GCTAAAAAATGTGGCCCAA -> CTAAAAAATGTGGCCCAAC
GCTAAAGCCACTTCCACAC -> CTAAAGCCACTTCCACACT
GCTAACTGTTCTGCGTCTG -> CTAACTGTTCTGCGTCTGT
GCTAAGTGTGCCATTCAAT -> CTAAGTGTGCCATTCAATA
GCTACAGACCGCTGTTGTA -> CTACAGACCGCTGTTGTAG
GCTAGGAGGGCATTGCTTG -> CTAGGAGGGCATTGCTTGC
GCTATCTTGATCTGCCAGT -> CTATCTTGATCTGCCAGTA
GCTATGTCGAGTCAGTTCA -> CTATGTCGAGTCAGTTCAC
GCTCAAAGTCATCTATGCT -> CTCAAAGTCATCTATGCTG
GCTCAACAGTGAGAGGGCA -> CTCAACAGTGAGAGGGCAG
GCTCACGAAAAAGGCGACC -> CTCACGAAAAAGGCGACCT
GCTCCACCGCGGCGGATAC -> CTCCACCGCGGCGGATACT
GCTCCAGACCACTGGAACT -> CTCCAGACCACTGGAACTC
GCTCCGTTTCAACGAAGGC -> CTCCGTTTCAACGAAGGCG
GCTCGCCCCCTGGTAAAAA -> CTCGCCCCCTGGTAAAAAC
GCTCGGCGTCCGGGATTCT -> CTCGGCGTCCGGGATTCTT
GCTCTCGAGGTTTCCAGTG -> CTCTCGAGGTTTCCAGTGC
GCTGACGGAAGTGGCTTGG -> CTGACGGAAGTGGCTTGGC
GCTGACGGGGCGTTTTGCA -> CTGACGGGGCGTTTTGCAG
GCTGAGGCCCCCATGGTAT -> CTGAGGCCCCCATGGTATT
GCTGCCTCAACGGGTTTGA -> CTGCCTCAACGGGTTTGAA
GCTGCTAACTGTTCTGCGT -> CTGCTAACTGTTCTGCGTC
GCTGGAGCTCCAGACCACT -> CTGGAGCTCCAGACCACTG
GCTGGGTCACTAGATGGTC -> CTGGGTCACTAGATGGTCT
GCTGGTCCTGTTAGCATAC -> CTGGTCCTGTTAGCATACA
GCTGTAATGAAATGGCGGA -> CTGTAATGAAATGGCGGAA
GCTGTCATATTTACAAGTA -> CTGTCATATTTACAAGTAG
GCTGTTGTAGTGCGAGATC -> CTGTTGTAGTGCGAGATCC
GCTTAACCTCCGCGTATCG -> CTTAACCTCCGCGTATCGT
GCTTACCTTAGGGCCCTGA -> CTTACCTTAGGGCCCTGAC
GCTTCAAAATCTGCGCGAC -> CTTCAAAATCTGCGCGACC
GCTTCGTGTGCACCCATCC -> CTTCGTGTGCACCCATCCC
GCTTGCACCCCCAGTTTAT -> CTTGCACCCCCAGTTTATG
GCTTGCTCTCGAGGTTTCC -> CTTGCTCTCGAGGTTTCCA
GCTTGGATGTGATGGGTGT -> CTTGGATGTGATGGGTGTT
GCTTGGCGAGTTATAGGCG -> CTTGGCGAGTTATAGGCGC
GCTTGGGTAGCGCGTCCCG -> CTTGGGTAGCGCGTCCCGT
GCTTTACCCCTGGACACAA -> CTTTACCCCTGGACACAAA
GGAAACGATAAACGACTAC -> GAAACGATAAACGACTACG
GGAAAGCAAATTGACTTCT -> GAAAGCAAATTGACTTCTT
GGAAATTGTAAGGCTATCT -> GAAATTGTAAGGCTATCTT
GGAACACGGTTCCTCCGTT -> GAACACGGTTCCTCCGTTA
GGAACTCTAAGGAAACGAT -> GAACTCTAAGGAAACGATA
GGAAGGGAGGGCGGCTGCT -> GAAGGGAGGGCGGCTGCTA
GGAAGTGGCTTGGCGAGTT -> GAAGTGGCTTGGCGAGTTA
GGACACAAAAATAATTCAT -> GACACAAAAATAATTCATC
GGACAGTTCACAAATGTAT -> GACAGTTCACAAATGTATA
GGACATGAGCTTTACCCCT -> GACATGAGCTTTACCCCTG
GGACATGAGGTGCGCTGGT -> GACATGAGGTGCGCTGGTC
GGACATGAGTCCGGGAGTC -> GACATGAGTCCGGGAGTCA
GGACGGGCTGACGGAAGTG -> GACGGGCTGACGGAAGTGG
GGACGTAGTACCGGTCGTG -> GACGTAGTACCGGTCGTGC
GGACTTTGAGTAGGCGGTA -> GACTTTGAGTAGGCGGTAG
GGAGCCCGGACAGTTCACA -> GAGCCCGGACAGTTCACAA
GGAGCTCCAGACCACTGGA -> GAGCTCCAGACCACTGGAA
GGAGGCTCGCCCCCTGGTA -> GAGGCTCGCCCCCTGGTAA
GGAGGGCATTGCTTGCTCT -> GAGGGCATTGCTTGCTCTC
GGAGGGCGGCTGCTAACTG -> GAGGGCGGCTGCTAACTGT
GGAGTAGCGATAACACGAC -> GAGTAGCGATAACACGACA
GGAGTCATCTCGCACCTAA -> GAGTCATCTCGCACCTAAG
GGAGTGCGTAACGGTCCCA -> GAGTGCGTAACGGTCCCAC
GGATACTACCTCGCGACAG -> GATACTACCTCGCGACAGC
GGATATAAACTACGAGCAA -> GATATAAACTACGAGCAAG
GGATATCTTTAATCCCTAA -> GATATCTTTAATCCCTAAA
GGATCACGGGCCATTCTGT -> GATCACGGGCCATTCTGTG
GGATCACTTTCGAGCCTAA -> GATCACTTTCGAGCCTAAA
GGATCTGCGGTATCTATGC -> GATCTGCGGTATCTATGCA
GGATCTTATGGTTGCATCA -> GATCTTATGGTTGCATCAC
GGATGGAGTAGCGATAACA -> GATGGAGTAGCGATAACAC
GGATGTCCGCCCTAACTAA -> GATGTCCGCCCTAACTAAA
GGATGTCTTATACCCGATA -> GATGTCTTATACCCGATAG
GGATGTGATGGGTGTTAGT -> GATGTGATGGGTGTTAGTA
GGATTCTTTGCAGATCCCC -> GATTCTTTGCAGATCCCCC
GGATTTTAGTCAGCGCTAA -> GATTTTAGTCAGCGCTAAA
GGCAAACCAGAGAGTAACT -> GCAAACCAGAGAGTAACTC
GGCAATCCCGCACTAGGTT -> GCAATCCCGCACTAGGTTT
GGCACCCCCTTATGCGCAC -> GCACCCCCTTATGCGCACA
GGCACTTCCCATAACACTA -> GCACTTCCCATAACACTAT
GGCAGCACTGCGATCCAGA -> GCAGCACTGCGATCCAGAC
GGCAGGCAATCCCGCACTA -> GCAGGCAATCCCGCACTAG
GGCATTGCTTGCTCTCGAG -> GCATTGCTTGCTCTCGAGG
GGCCAGGGTCAAATTTACC -> GCCAGGGTCAAATTTACCG
GGCCATTCTGTGGCGCAAT -> GCCATTCTGTGGCGCAATG
GGCCCAACACTGCTGTAAT -> GCCCAACACTGCTGTAATG
GGCCCAACGCAGCCTCATC -> GCCCAACGCAGCCTCATCG
GGCCCAACGGGACATGAGC -> GCCCAACGGGACATGAGCT
GGCCCAACTGTCTACCACA -> GCCCAACTGTCTACCACAC
GGCCCCCATGGTATTATTT -> GCCCCCATGGTATTATTTC
GGCCCTGACAGCTACAGAC -> GCCCTGACAGCTACAGACC
GGCCCTTAGCATCGTCCTG -> GCCCTTAGCATCGTCCTGG
GGCCTTGCTCACGAAAAAG -> GCCTTGCTCACGAAAAAGG
GGCGACCTCAGCTGAGGCC -> GCGACCTCAGCTGAGGCCC
GGCGAGCGTGAGCGGAGCC -> GCGAGCGTGAGCGGAGCCC
GGCGAGTTATAGGCGCCAG -> GCGAGTTATAGGCGCCAGC
GGCGCAATGCGTACATTGT -> GCGCAATGCGTACATTGTG
GGCGCCAGCAAAGGGTCAG -> GCGCCAGCAAAGGGTCAGC
GGCGGAACACGGTTCCTCC -> GCGGAACACGGTTCCTCCG
GGCGGACGTAGTACCGGTC -> GCGGACGTAGTACCGGTCG
GGCGGATACTACCTCGCGA -> GCGGATACTACCTCGCGAC
GGCGGATGTCTTATACCCG -> GCGGATGTCTTATACCCGA
GGCGGCCAGGGTCAAATTT -> GCGGCCAGGGTCAAATTTA
GGCGGCCCTTAGCATCGTC -> GCGGCCCTTAGCATCGTCC
GGCGGCTGCTAACTGTTCT -> GCGGCTGCTAACTGTTCTG
GGCGGGTGTTATAAATTAA -> GCGGGTGTTATAAATTAAG
GGCGGTAGGCACTTCCCAT -> GCGGTAGGCACTTCCCATA
GGCGGTATTCTTAGCTCGG -> GCGGTATTCTTAGCTCGGC
GGCGGTCTCTCTTGTATTT -> GCGGTCTCTCTTGTATTTT
GGCGTCCGGGATTCTTTGC -> GCGTCCGGGATTCTTTGCA
GGCGTTTTGCAGATCCCCC -> GCGTTTTGCAGATCCCCCG
GGCTAAAGCCACTTCCACA -> GCTAAAGCCACTTCCACAC
GGCTAGGAGGGCATTGCTT -> GCTAGGAGGGCATTGCTTG
GGCTATCTTGATCTGCCAG -> GCTATCTTGATCTGCCAGT
GGCTCAAAGTCATCTATGC -> GCTCAAAGTCATCTATGCT
GGCTCGCCCCCTGGTAAAA -> GCTCGCCCCCTGGTAAAAA
GGCTGACGGAAGTGGCTTG -> GCTGACGGAAGTGGCTTGG
GGCTGCTAACTGTTCTGCG -> GCTGCTAACTGTTCTGCGT
GGCTGGGTCACTAGATGGT -> GCTGGGTCACTAGATGGTC
GGCTTCAAAATCTGCGCGA -> GCTTCAAAATCTGCGCGAC
GGCTTGGCGAGTTATAGGC -> GCTTGGCGAGTTATAGGCG
GGCTTGGGTAGCGCGTCCC -> GCTTGGGTAGCGCGTCCCG
GGGAAAGCAAATTGACTTC -> GGAAAGCAAATTGACTTCT
GGGAAATTGTAAGGCTATC -> GGAAATTGTAAGGCTATCT
GGGACATGAGCTTTACCCC -> GGACATGAGCTTTACCCCT
GGGACATGAGGTGCGCTGG -> GGACATGAGGTGCGCTGGT
GGGACATGAGTCCGGGAGT -> GGACATGAGTCCGGGAGTC
GGGAGGGCGGCTGCTAACT -> GGAGGGCGGCTGCTAACTG
GGGAGTCATCTCGCACCTA -> GGAGTCATCTCGCACCTAA
GGGATCTGCGGTATCTATG -> GGATCTGCGGTATCTATGC
GGGATTCTTTGCAGATCCC -> GGATTCTTTGCAGATCCCC
GGGCAAACCAGAGAGTAAC -> GGCAAACCAGAGAGTAACT
GGGCACCCCCTTATGCGCA -> GGCACCCCCTTATGCGCAC
GGGCAGCACTGCGATCCAG -> GGCAGCACTGCGATCCAGA
GGGCATTGCTTGCTCTCGA -> GGCATTGCTTGCTCTCGAG
GGGCCATTCTGTGGCGCAA -> GGCCATTCTGTGGCGCAAT
GGGCCCTGACAGCTACAGA -> GGCCCTGACAGCTACAGAC
GGGCGGACGTAGTACCGGT -> GGCGGACGTAGTACCGGTC
GGGCGGCTGCTAACTGTTC -> GGCGGCTGCTAACTGTTCT
GGGCGGGTGTTATAAATTA -> GGCGGGTGTTATAAATTAA
GGGCGTTTTGCAGATCCCC -> GGCGTTTTGCAGATCCCCC
GGGCTAGGAGGGCATTGCT -> GGCTAGGAGGGCATTGCTT
GGGCTCAAAGTCATCTATG -> GGCTCAAAGTCATCTATGC
GGGCTGACGGAAGTGGCTT -> GGCTGACGGAAGTGGCTTG
GGGGACATGAGGTGCGCTG -> GGGACATGAGGTGCGCTGG
GGGGATCTGCGGTATCTAT -> GGGATCTGCGGTATCTATG
GGGGCGGACGTAGTACCGG -> GGGCGGACGTAGTACCGGT
GGGGCGGGTGTTATAAATT -> GGGCGGGTGTTATAAATTA
GGGGCGTTTTGCAGATCCC -> GGGCGTTTTGCAGATCCCC
GGGGCTAGGAGGGCATTGC -> GGGCTAGGAGGGCATTGCT
GGGGGACATGAGGTGCGCT -> GGGGACATGAGGTGCGCTG
GGGGGATCTGCGGTATCTA -> GGGGATCTGCGGTATCTAT
GGGGGGATCTGCGGTATCT -> GGGGGATCTGCGGTATCTA
GGGGGGTTCACATCGGGGC -> GGGGGTTCACATCGGGGCG
GGGGGTTCACATCGGGGCG -> GGGGTTCACATCGGGGCGG
GGGGTTCACATCGGGGCGG -> GGGTTCACATCGGGGCGGA
GGGGTTTGCAGATCCCCCG -> GGGTTTGCAGATCCCCCGG
GGGTAGCGCGTCCCGTCAC -> GGTAGCGCGTCCCGTCACA
GGGTCAAATTTACCGGTGC -> GGTCAAATTTACCGGTGCT
GGGTCACTAGATGGTCTCT -> GGTCACTAGATGGTCTCTA
GGGTCAGCCATCTGCGCTT -> GGTCAGCCATCTGCGCTTA
GGGTGTTAGTACGGCGGCC -> GGTGTTAGTACGGCGGCCA
GGGTGTTATAAATTAAGGT -> GGTGTTATAAATTAAGGTT
GGGTTCACATCGGGGCGGA -> GGTTCACATCGGGGCGGAC
GGGTTTCGATAATGCTTGC -> GGTTTCGATAATGCTTGCA
GGGTTTGAATTGCATGGGG -> GGTTTGAATTGCATGGGGT
GGGTTTGCAGATCCCCCGG -> GGTTTGCAGATCCCCCGGA
GGTAAAAACGAGGATCACG -> GTAAAAACGAGGATCACGG
GGTAGCGCGTCCCGTCACA -> GTAGCGCGTCCCGTCACAC
GGTAGGCACTTCCCATAAC -> GTAGGCACTTCCCATAACA
GGTATCTATGCAACTACCT -> GTATCTATGCAACTACCTA
GGTATTATTTCTTAGACAT -> GTATTATTTCTTAGACATA
GGTATTCTTAGCTCGGCGT -> GTATTCTTAGCTCGGCGTC
GGTCAAATTTACCGGTGCT -> GTCAAATTTACCGGTGCTG
GGTCACTAGATGGTCTCTA -> GTCACTAGATGGTCTCTAG
GGTCAGCCATCTGCGCTTA -> GTCAGCCATCTGCGCTTAA
GGTCCCACCGTACGAGATT -> GTCCCACCGTACGAGATTC
GGTCCTGTTAGCATACATG -> GTCCTGTTAGCATACATGG
GGTCGATGATAATTCTAAG -> GTCGATGATAATTCTAAGA
GGTCGTGCGGATATAAACT -> GTCGTGCGGATATAAACTA
GGTCTCTAGCTCCGTTTCA -> GTCTCTAGCTCCGTTTCAA
GGTCTCTCTTGTATTTTTT -> GTCTCTCTTGTATTTTTTT
GGTCTGGGAAATTGTAAGG -> GTCTGGGAAATTGTAAGGC
GGTGAACTCACTAGTAGCT -> GTGAACTCACTAGTAGCTC
GGTGCGCTGGTCCTGTTAG -> GTGCGCTGGTCCTGTTAGC
GGTGCGGTCTGGGAAATTG -> GTGCGGTCTGGGAAATTGT
GGTGCTGGAGCTCCAGACC -> GTGCTGGAGCTCCAGACCA
GGTGTTAGTACGGCGGCCA -> GTGTTAGTACGGCGGCCAG
GGTGTTATAAATTAAGGTT -> GTGTTATAAATTAAGGTTC
GGTTCACATCGGGGCGGAC -> GTTCACATCGGGGCGGACG
GGTTCCTAGACTTGATACG -> GTTCCTAGACTTGATACGC
GGTTCCTCCGTTATCCGAG -> GTTCCTCCGTTATCCGAGG
GGTTCTCTTCACAGAGTGC -> GTTCTCTTCACAGAGTGCC
GGTTGCATCACATACGTGT -> GTTGCATCACATACGTGTC
GGTTTCCAGTGCTGACGGG -> GTTTCCAGTGCTGACGGGG
GGTTTCCCCAGTGGGCACC -> GTTTCCCCAGTGGGCACCC
GGTTTCGATAATGCTTGCA -> GTTTCGATAATGCTTGCAC
GGTTTGAATTGCATGGGGT -> GTTTGAATTGCATGGGGTT
GGTTTGCAGATCCCCCGGA -> GTTTGCAGATCCCCCGGAT
GTAAAAACGAGGATCACGG -> TAAAAACGAGGATCACGGG
GTAACAGCGCTTACCTTAG -> TAACAGCGCTTACCTTAGG
GTAACGGTCCCACCGTACG -> TAACGGTCCCACCGTACGA
GTAACGTTGCTGTCATATT -> TAACGTTGCTGTCATATTT
GTAACTCCCCTGCTTGGAT -> TAACTCCCCTGCTTGGATG
GTAAGGCTATCTTGATCTG -> TAAGGCTATCTTGATCTGC
GTAATGAAATGGCGGAACA -> TAATGAAATGGCGGAACAC
GTAATGACTTATGGACGGG -> TAATGACTTATGGACGGGC
GTACATTGTGCCCCAATGA -> TACATTGTGCCCCAATGAT
GTACCGGTCGTGCGGATAT -> TACCGGTCGTGCGGATATA
GTACCTGCATATCTTGCCT -> TACCTGCATATCTTGCCTT
GTACGACTCTGAGGGGGGT -> TACGACTCTGAGGGGGGTT
GTACGAGATTCATGTCACC -> TACGAGATTCATGTCACCC
GTACGGCGGCCAGGGTCAA -> TACGGCGGCCAGGGTCAAA
GTACTCCTAATAGTAGACT -> TACTCCTAATAGTAGACTA
GTAGACTATGGCGAGCGTG -> TAGACTATGGCGAGCGTGA
GTAGATTCCACTGATCTCG -> TAGATTCCACTGATCTCGA
GTAGCGATAACACGACAAG -> TAGCGATAACACGACAAGG
GTAGCGCGTCCCGTCACAC -> TAGCGCGTCCCGTCACACA
GTAGCTCAACAGTGAGAGG -> TAGCTCAACAGTGAGAGGG
GTAGGCACTTCCCATAACA -> TAGGCACTTCCCATAACAC
GTAGGCGGTAGGCACTTCC -> TAGGCGGTAGGCACTTCCC
GTAGGTCGATGATAATTCT -> TAGGTCGATGATAATTCTA
GTAGTACCGGTCGTGCGGA -> TAGTACCGGTCGTGCGGAT
GTAGTGCGAGATCCGCACC -> TAGTGCGAGATCCGCACCT
GTATATACCGCCTCGACTA -> TATATACCGCCTCGACTAA
GTATCGTACGACTCTGAGG -> TATCGTACGACTCTGAGGG
GTATCTATGCAACTACCTA -> TATCTATGCAACTACCTAG
GTATTATTTCTTAGACATA -> TATTATTTCTTAGACATAC
GTATTCTCAGTGCCAGCAA -> TATTCTCAGTGCCAGCAAT
GTATTCTTAGCTCGGCGTC -> TATTCTTAGCTCGGCGTCC
GTATTTCCAGAGTGTTCCC -> TATTTCCAGAGTGTTCCCT
GTATTTTTTTGTCAAATTA -> TATTTTTTTGTCAAATTAA
GTCAAATTAAACAGCACGG -> TCAAATTAAACAGCACGGG
GTCAAATTTACCGGTGCTG -> TCAAATTTACCGGTGCTGG
GTCACACAAGTATTCTCAG -> TCACACAAGTATTCTCAGT
GTCACCCTGAGTACTCCTA -> TCACCCTGAGTACTCCTAA
GTCACCTAGTATTTCCAGA -> TCACCTAGTATTTCCAGAG
GTCACGGCGGTCTCTCTTG -> TCACGGCGGTCTCTCTTGT
GTCACGGGTTTCGATAATG -> TCACGGGTTTCGATAATGC
GTCACTAGATGGTCTCTAG -> TCACTAGATGGTCTCTAGC
GTCAGCCATCTGCGCTTAA -> TCAGCCATCTGCGCTTAAC
GTCAGCGCTAAAAAATGTG -> TCAGCGCTAAAAAATGTGG
GTCAGTTCACTCCCCGTTC -> TCAGTTCACTCCCCGTTCC
GTCATATGTAGATTCCACT -> TCATATGTAGATTCCACTG
GTCATATTTACAAGTAGGT -> TCATATTTACAAGTAGGTC
GTCATCTATGCTGCCTCAA -> TCATCTATGCTGCCTCAAC
GTCATCTCGCACCTAAGGG -> TCATCTCGCACCTAAGGGC
GTCCCACCGTACGAGATTC -> TCCCACCGTACGAGATTCA
GTCCCGTCACACAAGTATT -> TCCCGTCACACAAGTATTC
GTCCGCCCTAACTAAAAAA -> TCCGCCCTAACTAAAAAAT
GTCCGGGAGTCATCTCGCA -> TCCGGGAGTCATCTCGCAC
GTCCGGGATTCTTTGCAGA -> TCCGGGATTCTTTGCAGAT
GTCCGTCACGGCGGTCTCT -> TCCGTCACGGCGGTCTCTC
GTCCTGGTGCGGTCTGGGA -> TCCTGGTGCGGTCTGGGAA
GTCCTGTTAGCATACATGG -> TCCTGTTAGCATACATGGA
GTCGAGTCAGTTCACTCCC -> TCGAGTCAGTTCACTCCCC
GTCGATGATAATTCTAAGA -> TCGATGATAATTCTAAGAT
GTCGTGCGGATATAAACTA -> TCGTGCGGATATAAACTAC
GTCTCTAGCTCCGTTTCAA -> TCTCTAGCTCCGTTTCAAC
GTCTCTCTTGTATTTTTTT -> TCTCTCTTGTATTTTTTTG
GTCTGGCTTCAAAATCTGC -> TCTGGCTTCAAAATCTGCG
GTCTGGGAAATTGTAAGGC -> TCTGGGAAATTGTAAGGCT
GTCTGTACCTGCATATCTT -> TCTGTACCTGCATATCTTG
GTCTTATACCCGATAGTAA -> TCTTATACCCGATAGTAAC
GTCTTGAGTCTGGCTTCAA -> TCTTGAGTCTGGCTTCAAA
GTGAACTCACTAGTAGCTC -> TGAACTCACTAGTAGCTCA
GTGACTGTCTTGAGTCTGG -> TGACTGTCTTGAGTCTGGC
GTGAGAGGGCAGCACTGCG -> TGAGAGGGCAGCACTGCGA
GTGAGCGGAGCCCGGACAG -> TGAGCGGAGCCCGGACAGT
GTGATGGGTGTTAGTACGG -> TGATGGGTGTTAGTACGGC
GTGCACCCATCCCTTCGGA -> TGCACCCATCCCTTCGGAA
GTGCATCGAGAACGTTCGT -> TGCATCGAGAACGTTCGTT
GTGCCAGCAATGCGAGCTA -> TGCCAGCAATGCGAGCTAT
GTGCCATTCAATAGACGGT -> TGCCATTCAATAGACGGTT
GTGCCCCAATGATCCCAAG -> TGCCCCAATGATCCCAAGG
GTGCCGGAGGCTCGCCCCC -> TGCCGGAGGCTCGCCCCCT
GTGCGAGATCCGCACCTCC -> TGCGAGATCCGCACCTCCG
GTGCGCTGGTCCTGTTAGC -> TGCGCTGGTCCTGTTAGCA
GTGCGGATATAAACTACGA -> TGCGGATATAAACTACGAG
GTGCGGTCTGGGAAATTGT -> TGCGGTCTGGGAAATTGTA
GTGCGTAACGGTCCCACCG -> TGCGTAACGGTCCCACCGT
GTGCTCCACCGCGGCGGAT -> TGCTCCACCGCGGCGGATA
GTGCTGACGGGGCGTTTTG -> TGCTGACGGGGCGTTTTGC
GTGCTGGAGCTCCAGACCA -> TGCTGGAGCTCCAGACCAC
GTGGCCCAACACTGCTGTA -> TGGCCCAACACTGCTGTAA
GTGGCCCAACGCAGCCTCA -> TGGCCCAACGCAGCCTCAT
GTGGCCCAACGGGACATGA -> TGGCCCAACGGGACATGAG
GTGGCCCAACTGTCTACCA -> TGGCCCAACTGTCTACCAC
GTGGCGCAATGCGTACATT -> TGGCGCAATGCGTACATTG
GTGGCTTGGCGAGTTATAG -> TGGCTTGGCGAGTTATAGG
GTGGGCACCCCCTTATGCG -> TGGGCACCCCCTTATGCGC
GTGGGGGGATCTGCGGTAT -> TGGGGGGATCTGCGGTATC
GTGTCCGTCACGGCGGTCT -> TGTCCGTCACGGCGGTCTC
GTGTGCACCCATCCCTTCG -> TGTGCACCCATCCCTTCGG
GTGTGCCATTCAATAGACG -> TGTGCCATTCAATAGACGG
GTGTTAGTACGGCGGCCAG -> TGTTAGTACGGCGGCCAGG
GTGTTATAAATTAAGGTTC -> TGTTATAAATTAAGGTTCC
GTGTTCCCTGTGCTCCACC -> TGTTCCCTGTGCTCCACCG
GTTAGCATACATGGATCTT -> TTAGCATACATGGATCTTA
GTTAGTACGGCGGCCAGGG -> TTAGTACGGCGGCCAGGGT
GTTATAAATTAAGGTTCCT -> TTATAAATTAAGGTTCCTA
GTTATAGGCGCCAGCAAAG -> TTATAGGCGCCAGCAAAGG
GTTATCCGAGGCAGGCAAT -> TTATCCGAGGCAGGCAATC
GTTCACAAATGTATATACC -> TTCACAAATGTATATACCG
GTTCACATCCCATCCCGAC -> TTCACATCCCATCCCGACC
GTTCACATCGGGGCGGACG -> TTCACATCGGGGCGGACGT
GTTCACTCCCCGTTCCTGC -> TTCACTCCCCGTTCCTGCC
GTTCCCTGTGCTCCACCGC -> TTCCCTGTGCTCCACCGCG
GTTCCTAGACTTGATACGC -> TTCCTAGACTTGATACGCA
GTTCCTCCGTTATCCGAGG -> TTCCTCCGTTATCCGAGGC
GTTCCTGCCTTAACTCTGG -> TTCCTGCCTTAACTCTGGC
GTTCGTTTAGGCTAAAGCC -> TTCGTTTAGGCTAAAGCCA
GTTCTCTTCACAGAGTGCC -> TTCTCTTCACAGAGTGCCG
GTTCTGCGTCTGTACCTGC -> TTCTGCGTCTGTACCTGCA
GTTGCATCACATACGTGTC -> TTGCATCACATACGTGTCC
GTTGCTGTCATATTTACAA -> TTGCTGTCATATTTACAAG
GTTGTAGTGCGAGATCCGC -> TTGTAGTGCGAGATCCGCA
GTTTAGGCTAAAGCCACTT -> TTTAGGCTAAAGCCACTTC
GTTTATGCGAAATTAGTGG -> TTTATGCGAAATTAGTGGG
GTTTCAACGAAGGCGGATG -> TTTCAACGAAGGCGGATGT
GTTTCCAGTGCTGACGGGG -> TTTCCAGTGCTGACGGGGC
GTTTCCCCAGTGGGCACCC -> TTTCCCCAGTGGGCACCCC
GTTTCGATAATGCTTGCAC -> TTTCGATAATGCTTGCACC
GTTTGAATTGCATGGGGTT -> TTTGAATTGCATGGGGTTT
GTTTGCAGATCCCCCGGAT -> TTTGCAGATCCCCCGGATG
GTTTTGCAGATCCCCCGGA -> TTTTGCAGATCCCCCGGAT
TAAAAAATGTGGCCCAACA -> AAAAAATGTGGCCCAACAC
TAAAAAATGTGGCCCAACG -> AAAAAATGTGGCCCAACGC,AAAAAATGTGGCCCAACGG
TAAAAAATGTGGCCCAACT -> AAAAAATGTGGCCCAACTG
TAAAAACGAGGATCACGGG -> AAAAACGAGGATCACGGGC
TAAAAACGAGTCACGGGTT -> AAAAACGAGTCACGGGTTT
TAAAAGTAACGTTGCTGTC -> AAAAGTAACGTTGCTGTCA
TAAACAGCACGGGGCTAGG -> AAACAGCACGGGGCTAGGA
TAAACGACTACGTGCATCG -> AAACGACTACGTGCATCGA
TAAACTACGAGCAAGACCC -> AAACTACGAGCAAGACCCG
TAAAGCCACTTCCACACTT -> AAAGCCACTTCCACACTTA
TAAATTAAGGTTCCTAGAC -> AAATTAAGGTTCCTAGACT
TAACACGACAAGGGACATG -> AACACGACAAGGGACATGA
TAACACTATCCCGGATGGA -> AACACTATCCCGGATGGAG
TAACAGCGCTTACCTTAGG -> AACAGCGCTTACCTTAGGG
TAACCTCCGCGTATCGTAC -> AACCTCCGCGTATCGTACG
TAACGGTCCCACCGTACGA -> AACGGTCCCACCGTACGAG
TAACGTTGCTGTCATATTT -> AACGTTGCTGTCATATTTA
TAACTAAAAAATGTGGCCC -> AACTAAAAAATGTGGCCCA
TAACTCCCCTGCTTGGATG -> AACTCCCCTGCTTGGATGT
TAACTCTGGCCTTGCTCAC -> AACTCTGGCCTTGCTCACG
TAACTGTTCTGCGTCTGTA -> AACTGTTCTGCGTCTGTAC
TAAGATTTGCATATTCTTG -> AAGATTTGCATATTCTTGC
TAAGGAAACGATAAACGAC -> AAGGAAACGATAAACGACT
TAAGGCTATCTTGATCTGC -> AAGGCTATCTTGATCTGCC
TAAGGGCTCAAAGTCATCT -> AAGGGCTCAAAGTCATCTA
TAAGGTTCCTAGACTTGAT -> AAGGTTCCTAGACTTGATA
TAAGTGTGCCATTCAATAG -> AAGTGTGCCATTCAATAGA
TAATAGTAGACTATGGCGA -> AATAGTAGACTATGGCGAG
TAATCCCTAAAAAATGTGG -> AATCCCTAAAAAATGTGGC
TAATGAAATGGCGGAACAC -> AATGAAATGGCGGAACACG
TAATGACTTATGGACGGGC -> AATGACTTATGGACGGGCT
TAATGCTTCGTGTGCACCC -> AATGCTTCGTGTGCACCCA
TAATGCTTGCACCCCCAGT -> AATGCTTGCACCCCCAGTT
TAATTCATCGCCCCCAGCT -> AATTCATCGCCCCCAGCTA
TAATTCTAAGATTTGCATA -> AATTCTAAGATTTGCATAT
TACAAGTAGGTCGATGATA -> ACAAGTAGGTCGATGATAA
TACAGACCGCTGTTGTAGT -> ACAGACCGCTGTTGTAGTG
TACATGGATCTTATGGTTG -> ACATGGATCTTATGGTTGC
TACATTGTGCCCCAATGAT -> ACATTGTGCCCCAATGATC
TACCCCTGGACACAAAAAT -> ACCCCTGGACACAAAAATA
TACCCGATAGTAACAGCGC -> ACCCGATAGTAACAGCGCT
TACCGCCTCGACTAAAAAC -> ACCGCCTCGACTAAAAACG
TACCGGTCGTGCGGATATA -> ACCGGTCGTGCGGATATAA
TACCGGTGCTGGAGCTCCA -> ACCGGTGCTGGAGCTCCAG
TACCTAGGCTGGGTCACTA -> ACCTAGGCTGGGTCACTAG
TACCTCGCGACAGCAGGCT -> ACCTCGCGACAGCAGGCTT
TACCTGCATATCTTGCCTT -> ACCTGCATATCTTGCCTTA
TACCTTAGGGCCCTGACAG -> ACCTTAGGGCCCTGACAGC
TACGACTCTGAGGGGGGTT -> ACGACTCTGAGGGGGGTTC
TACGAGATTCATGTCACCC -> ACGAGATTCATGTCACCCT
TACGAGCAAGACCCGAGAT -> ACGAGCAAGACCCGAGATT
TACGCAAATCAAGAGGAGT -> ACGCAAATCAAGAGGAGTG
TACGGCGGCCAGGGTCAAA -> ACGGCGGCCAGGGTCAAAT
TACGGGCAAACCAGAGAGT -> ACGGGCAAACCAGAGAGTA
TACGTGCATCGAGAACGTT -> ACGTGCATCGAGAACGTTC
TACGTGTCCGTCACGGCGG -> ACGTGTCCGTCACGGCGGT
TACTACCTCGCGACAGCAG -> ACTACCTCGCGACAGCAGG
TACTAGCGATGGGGGACAT -> ACTAGCGATGGGGGACATG
TACTCCTAATAGTAGACTA -> ACTCCTAATAGTAGACTAT
TAGACATACGGGCAAACCA -> AGACATACGGGCAAACCAG
TAGACGGTTCTCTTCACAG -> AGACGGTTCTCTTCACAGA
TAGACTATGGCGAGCGTGA -> AGACTATGGCGAGCGTGAG
TAGACTTGATACGCAAATC -> AGACTTGATACGCAAATCA
TAGATGGTCTCTAGCTCCG -> AGATGGTCTCTAGCTCCGT
TAGATTCCACTGATCTCGA -> AGATTCCACTGATCTCGAA
TAGCATACATGGATCTTAT -> AGCATACATGGATCTTATG
TAGCATCGTCCTGGTGCGG -> AGCATCGTCCTGGTGCGGT
TAGCGATAACACGACAAGG -> AGCGATAACACGACAAGGG
TAGCGATGGGGGACATGAG -> AGCGATGGGGGACATGAGG
TAGCGCGTCCCGTCACACA -> AGCGCGTCCCGTCACACAA
TAGCTCAACAGTGAGAGGG -> AGCTCAACAGTGAGAGGGC
TAGCTCCGTTTCAACGAAG -> AGCTCCGTTTCAACGAAGG
TAGCTCGGCGTCCGGGATT -> AGCTCGGCGTCCGGGATTC
TAGGAGGGCATTGCTTGCT -> AGGAGGGCATTGCTTGCTC
TAGGCACTTCCCATAACAC -> AGGCACTTCCCATAACACT
TAGGCGCCAGCAAAGGGTC -> AGGCGCCAGCAAAGGGTCA
TAGGCGGTAGGCACTTCCC -> AGGCGGTAGGCACTTCCCA
TAGGCTAAAGCCACTTCCA -> AGGCTAAAGCCACTTCCAC
TAGGCTGGGTCACTAGATG -> AGGCTGGGTCACTAGATGG
TAGGGCCCTGACAGCTACA -> AGGGCCCTGACAGCTACAG
TAGGTCGATGATAATTCTA -> AGGTCGATGATAATTCTAA
TAGGTTTCCCCAGTGGGCA -> AGGTTTCCCCAGTGGGCAC
TAGTAACAGCGCTTACCTT -> AGTAACAGCGCTTACCTTA
TAGTACCGGTCGTGCGGAT -> AGTACCGGTCGTGCGGATA
TAGTACGGCGGCCAGGGTC -> AGTACGGCGGCCAGGGTCA
TAGTAGACTATGGCGAGCG -> AGTAGACTATGGCGAGCGT
TAGTAGCTCAACAGTGAGA -> AGTAGCTCAACAGTGAGAG
TAGTATTTCCAGAGTGTTC -> AGTATTTCCAGAGTGTTCC
TAGTCAGCGCTAAAAAATG -> AGTCAGCGCTAAAAAATGT
TAGTGCGAGATCCGCACCT -> AGTGCGAGATCCGCACCTC
TAGTGGGGGGATCTGCGGT -> AGTGGGGGGATCTGCGGTA
TATAAACTACGAGCAAGAC -> ATAAACTACGAGCAAGACC
TATAAATTAAGGTTCCTAG -> ATAAATTAAGGTTCCTAGA
TATACCCGATAGTAACAGC -> ATACCCGATAGTAACAGCG
TATACCGCCTCGACTAAAA -> ATACCGCCTCGACTAAAAA
TATAGGCGCCAGCAAAGGG -> ATAGGCGCCAGCAAAGGGT
TATATACCGCCTCGACTAA -> ATATACCGCCTCGACTAAA
TATCCCGGATGGAGTAGCG -> ATCCCGGATGGAGTAGCGA
TATCCGAGGCAGGCAATCC -> ATCCGAGGCAGGCAATCCC
TATCGTACGACTCTGAGGG -> ATCGTACGACTCTGAGGGG
TATCTATGCAACTACCTAG -> ATCTATGCAACTACCTAGG
TATCTTGATCTGCCAGTAA -> ATCTTGATCTGCCAGTAAT
TATCTTGCCTTAAAAGTAA -> ATCTTGCCTTAAAAGTAAC
TATCTTTAATCCCTAAAAA -> ATCTTTAATCCCTAAAAAA
TATGCAACTACCTAGGCTG -> ATGCAACTACCTAGGCTGG
TATGCGAAATTAGTGGGGG -> ATGCGAAATTAGTGGGGGG
TATGCGCACAAACTGTTCA -> ATGCGCACAAACTGTTCAC
TATGCTGCCTCAACGGGTT -> ATGCTGCCTCAACGGGTTT
TATGGACGGGCTGACGGAA -> ATGGACGGGCTGACGGAAG
TATGGCGAGCGTGAGCGGA -> ATGGCGAGCGTGAGCGGAG
TATGGTTGCATCACATACG -> ATGGTTGCATCACATACGT
TATGTAGATTCCACTGATC -> ATGTAGATTCCACTGATCT
TATGTCGAGTCAGTTCACT -> ATGTCGAGTCAGTTCACTC
TATTATTTCTTAGACATAC -> ATTATTTCTTAGACATACG
TATTCGGCGGTATTCTTAG -> ATTCGGCGGTATTCTTAGC
TATTCTCAGTGCCAGCAAT -> ATTCTCAGTGCCAGCAATG
TATTCTTAGCTCGGCGTCC -> ATTCTTAGCTCGGCGTCCG
TATTCTTGCCAGAAAATTT -> ATTCTTGCCAGAAAATTTT
TATTGGTGAACTCACTAGT -> ATTGGTGAACTCACTAGTA
TATTTACAAGTAGGTCGAT -> ATTTACAAGTAGGTCGATG
TATTTCCAGAGTGTTCCCT -> ATTTCCAGAGTGTTCCCTG
TATTTCTTAGACATACGGG -> ATTTCTTAGACATACGGGC
TATTTTTTTGTCAAATTAA -> ATTTTTTTGTCAAATTAAA
TCAAAATCTGCGCGACCTA -> CAAAATCTGCGCGACCTAT
TCAAAGTCATCTATGCTGC -> CAAAGTCATCTATGCTGCC
TCAAATTAAACAGCACGGG -> CAAATTAAACAGCACGGGG
TCAAATTTACCGGTGCTGG -> CAAATTTACCGGTGCTGGA
TCAACAGTGAGAGGGCAGC -> CAACAGTGAGAGGGCAGCA
TCAACGAAGGCGGATGTCT -> CAACGAAGGCGGATGTCTT
TCAACGGGTTTGAATTGCA -> CAACGGGTTTGAATTGCAT
TCAAGAGGAGTGCGTAACG -> CAAGAGGAGTGCGTAACGG
TCAATAGACGGTTCTCTTC -> CAATAGACGGTTCTCTTCA
TCACAAATGTATATACCGC -> CACAAATGTATATACCGCC
TCACACAAGTATTCTCAGT -> CACACAAGTATTCTCAGTG
TCACAGAGTGCCGGAGGCT -> CACAGAGTGCCGGAGGCTC
TCACATACGTGTCCGTCAC -> CACATACGTGTCCGTCACG
TCACATCCCATCCCGACCC -> CACATCCCATCCCGACCCG
TCACATCGGGGCGGACGTA -> CACATCGGGGCGGACGTAG
TCACCCTGAGTACTCCTAA -> CACCCTGAGTACTCCTAAT
TCACCTAGTATTTCCAGAG -> CACCTAGTATTTCCAGAGT
TCACGAAAAAGGCGACCTC -> CACGAAAAAGGCGACCTCA
TCACGGCGGTCTCTCTTGT -> CACGGCGGTCTCTCTTGTA
TCACGGGCCATTCTGTGGC -> CACGGGCCATTCTGTGGCG
TCACGGGTTTCGATAATGC -> CACGGGTTTCGATAATGCT
TCACTAGATGGTCTCTAGC -> CACTAGATGGTCTCTAGCT
TCACTAGTAGCTCAACAGT -> CACTAGTAGCTCAACAGTG
TCACTCCCCGTTCCTGCCT -> CACTCCCCGTTCCTGCCTT
TCACTTTCGAGCCTAAAAA -> CACTTTCGAGCCTAAAAAA
TCAGCCATCTGCGCTTAAC -> CAGCCATCTGCGCTTAACC
TCAGCGCTAAAAAATGTGG -> CAGCGCTAAAAAATGTGGC
TCAGCTGAGGCCCCCATGG -> CAGCTGAGGCCCCCATGGT
TCAGTGCCAGCAATGCGAG -> CAGTGCCAGCAATGCGAGC
TCAGTTCACTCCCCGTTCC -> CAGTTCACTCCCCGTTCCT
TCATAATGCTTCGTGTGCA -> CATAATGCTTCGTGTGCAC
TCATATGTAGATTCCACTG -> CATATGTAGATTCCACTGA
TCATATTTACAAGTAGGTC -> CATATTTACAAGTAGGTCG
TCATCGCCCCCAGCTAAGT -> CATCGCCCCCAGCTAAGTG
TCATCGGACTTTGAGTAGG -> CATCGGACTTTGAGTAGGC
TCATCTATGCTGCCTCAAC -> CATCTATGCTGCCTCAACG
TCATCTCGCACCTAAGGGC -> CATCTCGCACCTAAGGGCT
TCATGTCACCCTGAGTACT -> CATGTCACCCTGAGTACTC
TCCAACCTCGGCGGCCCTT -> CCAACCTCGGCGGCCCTTA
TCCACACTTATTCGGCGGT -> CCACACTTATTCGGCGGTA
TCCACCGCGGCGGATACTA -> CCACCGCGGCGGATACTAC
TCCACTGATCTCGAATTTG -> CCACTGATCTCGAATTTGC
TCCAGACCACTGGAACTCT -> CCAGACCACTGGAACTCTA
TCCAGACGCCCCCTCCAGT -> CCAGACGCCCCCTCCAGTC
TCCAGAGTGTTCCCTGTGC -> CCAGAGTGTTCCCTGTGCT
TCCAGTCACCTAGTATTTC -> CCAGTCACCTAGTATTTCC
TCCAGTGCTGACGGGGCGT -> CCAGTGCTGACGGGGCGTT
TCCCAAGGGGCGGGTGTTA -> CCCAAGGGGCGGGTGTTAT
TCCCACCGTACGAGATTCA -> CCCACCGTACGAGATTCAT
TCCCATAACACTATCCCGG -> CCCATAACACTATCCCGGA
TCCCATCCCGACCCGTCAT -> CCCATCCCGACCCGTCATA
TCCCCAGTGGGCACCCCCT -> CCCCAGTGGGCACCCCCTT
TCCCCCGGATATCTTTAAT -> CCCCCGGATATCTTTAATC
TCCCCCGGATCACTTTCGA -> CCCCCGGATCACTTTCGAG
TCCCCCGGATGTCCGCCCT -> CCCCCGGATGTCCGCCCTA
TCCCCCGGATTTTAGTCAG -> CCCCCGGATTTTAGTCAGC
TCCCCGTTCCTGCCTTAAC -> CCCCGTTCCTGCCTTAACT
TCCCCTGCTTGGATGTGAT -> CCCCTGCTTGGATGTGATG
TCCCGACCCGTCATATGTA -> CCCGACCCGTCATATGTAG
TCCCGCACTAGGTTTCCCC -> CCCGCACTAGGTTTCCCCA
TCCCGGATGGAGTAGCGAT -> CCCGGATGGAGTAGCGATA
TCCCGTCACACAAGTATTC -> CCCGTCACACAAGTATTCT
TCCCTAAAAAATGTGGCCC -> CCCTAAAAAATGTGGCCCA
TCCCTGTGCTCCACCGCGG -> CCCTGTGCTCCACCGCGGC
TCCCTTCGGAAGGGAGGGC -> CCCTTCGGAAGGGAGGGCG
TCCGAGGCAGGCAATCCCG -> CCGAGGCAGGCAATCCCGC
TCCGCACCTCCGTGACTGT -> CCGCACCTCCGTGACTGTC
TCCGCCCTAACTAAAAAAT -> CCGCCCTAACTAAAAAATG
TCCGCGTATCGTACGACTC -> CCGCGTATCGTACGACTCT
TCCGGGAGTCATCTCGCAC -> CCGGGAGTCATCTCGCACC
TCCGGGATTCTTTGCAGAT -> CCGGGATTCTTTGCAGATC
TCCGTCACGGCGGTCTCTC -> CCGTCACGGCGGTCTCTCT
TCCGTGACTGTCTTGAGTC -> CCGTGACTGTCTTGAGTCT
TCCGTTATCCGAGGCAGGC -> CCGTTATCCGAGGCAGGCA
TCCGTTTCAACGAAGGCGG -> CCGTTTCAACGAAGGCGGA
TCCTAATAGTAGACTATGG -> CCTAATAGTAGACTATGGC
TCCTAGACTTGATACGCAA -> CCTAGACTTGATACGCAAA
TCCTCCGTTATCCGAGGCA -> CCTCCGTTATCCGAGGCAG
TCCTGCCTTAACTCTGGCC -> CCTGCCTTAACTCTGGCCT
TCCTGGTGCGGTCTGGGAA -> CCTGGTGCGGTCTGGGAAA
TCCTGTTAGCATACATGGA -> CCTGTTAGCATACATGGAT
TCGAATTTGCAGATCCCCC -> CGAATTTGCAGATCCCCCG
TCGACTAAAAACGAGTCAC -> CGACTAAAAACGAGTCACG
TCGAGAACGTTCGTTTAGG -> CGAGAACGTTCGTTTAGGC
TCGAGCCTAAAAAATGTGG -> CGAGCCTAAAAAATGTGGC
TCGAGGTTTCCAGTGCTGA -> CGAGGTTTCCAGTGCTGAC
TCGAGTCAGTTCACTCCCC -> CGAGTCAGTTCACTCCCCG
TCGATAATGCTTGCACCCC -> CGATAATGCTTGCACCCCC
TCGATGATAATTCTAAGAT -> CGATGATAATTCTAAGATT
TCGCACCTAAGGGCTCAAA -> CGCACCTAAGGGCTCAAAG
TCGCCCCCAGCTAAGTGTG -> CGCCCCCAGCTAAGTGTGC
TCGCCCCCTGGTAAAAACG -> CGCCCCCTGGTAAAAACGA
TCGCGACAGCAGGCTTGGG -> CGCGACAGCAGGCTTGGGT
TCGGAAGGGAGGGCGGCTG -> CGGAAGGGAGGGCGGCTGC
TCGGACTTTGAGTAGGCGG -> CGGACTTTGAGTAGGCGGT
TCGGCGGCCCTTAGCATCG -> CGGCGGCCCTTAGCATCGT
TCGGCGGTATTCTTAGCTC -> CGGCGGTATTCTTAGCTCG
TCGGCGTCCGGGATTCTTT -> CGGCGTCCGGGATTCTTTG
TCGGGGCGGACGTAGTACC -> CGGGGCGGACGTAGTACCG
TCGTACGACTCTGAGGGGG -> CGTACGACTCTGAGGGGGG
TCGTCCTGGTGCGGTCTGG -> CGTCCTGGTGCGGTCTGGG
TCGTGCGGATATAAACTAC -> CGTGCGGATATAAACTACG
TCGTGTGCACCCATCCCTT -> CGTGTGCACCCATCCCTTC
TCGTTTAGGCTAAAGCCAC -> CGTTTAGGCTAAAGCCACT
TCTAAGATTTGCATATTCT -> CTAAGATTTGCATATTCTT
TCTAAGGAAACGATAAACG -> CTAAGGAAACGATAAACGA
TCTAGCTCCGTTTCAACGA -> CTAGCTCCGTTTCAACGAA
TCTATGCAACTACCTAGGC -> CTATGCAACTACCTAGGCT
TCTATGCTGCCTCAACGGG -> CTATGCTGCCTCAACGGGT
TCTCAGTGCCAGCAATGCG -> CTCAGTGCCAGCAATGCGA
TCTCGAATTTGCAGATCCC -> CTCGAATTTGCAGATCCCC
TCTCGAGGTTTCCAGTGCT -> CTCGAGGTTTCCAGTGCTG
TCTCGCACCTAAGGGCTCA -> CTCGCACCTAAGGGCTCAA
TCTCTAGCTCCGTTTCAAC -> CTCTAGCTCCGTTTCAACG
TCTCTCTTGTATTTTTTTG -> CTCTCTTGTATTTTTTTGT
TCTCTTCACAGAGTGCCGG -> CTCTTCACAGAGTGCCGGA
TCTCTTGTATTTTTTTGTC -> CTCTTGTATTTTTTTGTCA
TCTGAGGGGGGTTCACATC -> CTGAGGGGGGTTCACATCG
TCTGCCAGTAATGACTTAT -> CTGCCAGTAATGACTTATG
TCTGCGCGACCTATTGGTG -> CTGCGCGACCTATTGGTGA
TCTGCGCTTAACCTCCGCG -> CTGCGCTTAACCTCCGCGT
TCTGCGGTATCTATGCAAC -> CTGCGGTATCTATGCAACT
TCTGCGTCTGTACCTGCAT -> CTGCGTCTGTACCTGCATA
TCTGGCCTTGCTCACGAAA -> CTGGCCTTGCTCACGAAAA
TCTGGCTTCAAAATCTGCG -> CTGGCTTCAAAATCTGCGC
TCTGGGAAATTGTAAGGCT -> CTGGGAAATTGTAAGGCTA
TCTGTACCTGCATATCTTG -> CTGTACCTGCATATCTTGC
TCTGTGGCGCAATGCGTAC -> CTGTGGCGCAATGCGTACA
TCTTAGACATACGGGCAAA -> CTTAGACATACGGGCAAAC
TCTTAGCTCGGCGTCCGGG -> CTTAGCTCGGCGTCCGGGA
TCTTATACCCGATAGTAAC -> CTTATACCCGATAGTAACA
TCTTATGGTTGCATCACAT -> CTTATGGTTGCATCACATA
TCTTCACAGAGTGCCGGAG -> CTTCACAGAGTGCCGGAGG
TCTTCCAACCTCGGCGGCC -> CTTCCAACCTCGGCGGCCC
TCTTGAGTCTGGCTTCAAA -> CTTGAGTCTGGCTTCAAAA
TCTTGATCTGCCAGTAATG -> CTTGATCTGCCAGTAATGA
TCTTGCCAGAAAATTTTTA -> CTTGCCAGAAAATTTTTAC
TCTTGCCTTAAAAGTAACG -> CTTGCCTTAAAAGTAACGT
TCTTGTATTTTTTTGTCAA -> CTTGTATTTTTTTGTCAAA
TCTTTAATCCCTAAAAAAT -> CTTTAATCCCTAAAAAATG
TCTTTGCAGATCCCCCGGA -> CTTTGCAGATCCCCCGGAT
TGAAATGGCGGAACACGGT -> GAAATGGCGGAACACGGTT
TGAACTCACTAGTAGCTCA -> GAACTCACTAGTAGCTCAA
TGAATTGCATGGGGTTTGC -> GAATTGCATGGGGTTTGCA
TGACAGCTACAGACCGCTG -> GACAGCTACAGACCGCTGT
TGACGGAAGTGGCTTGGCG -> GACGGAAGTGGCTTGGCGA
TGACGGGGCGTTTTGCAGA -> GACGGGGCGTTTTGCAGAT
TGACTGTCTTGAGTCTGGC -> GACTGTCTTGAGTCTGGCT
TGACTTATGGACGGGCTGA -> GACTTATGGACGGGCTGAC
TGACTTCTTCCAACCTCGG -> GACTTCTTCCAACCTCGGC
TGAGAGGGCAGCACTGCGA -> GAGAGGGCAGCACTGCGAT
TGAGCGGAGCCCGGACAGT -> GAGCGGAGCCCGGACAGTT
TGAGCTTTACCCCTGGACA -> GAGCTTTACCCCTGGACAC
TGAGGCCCCCATGGTATTA -> GAGGCCCCCATGGTATTAT
TGAGGGGGGTTCACATCGG -> GAGGGGGGTTCACATCGGG
TGAGGTGCGCTGGTCCTGT -> GAGGTGCGCTGGTCCTGTT
TGAGTACTCCTAATAGTAG -> GAGTACTCCTAATAGTAGA
TGAGTAGGCGGTAGGCACT -> GAGTAGGCGGTAGGCACTT
TGAGTCCGGGAGTCATCTC -> GAGTCCGGGAGTCATCTCG
TGAGTCTGGCTTCAAAATC -> GAGTCTGGCTTCAAAATCT
TGATAATTCTAAGATTTGC -> GATAATTCTAAGATTTGCA
TGATACGCAAATCAAGAGG -> GATACGCAAATCAAGAGGA
TGATCCCAAGGGGCGGGTG -> GATCCCAAGGGGCGGGTGT
TGATCTCGAATTTGCAGAT -> GATCTCGAATTTGCAGATC
TGATCTGCCAGTAATGACT -> GATCTGCCAGTAATGACTT
TGATGGGTGTTAGTACGGC -> GATGGGTGTTAGTACGGCG
TGCAACTACCTAGGCTGGG -> GCAACTACCTAGGCTGGGT
TGCACCCATCCCTTCGGAA -> GCACCCATCCCTTCGGAAG
TGCACCCCCAGTTTATGCG -> GCACCCCCAGTTTATGCGA
TGCAGATCCCCCGGATATC -> GCAGATCCCCCGGATATCT
TGCAGATCCCCCGGATCAC -> GCAGATCCCCCGGATCACT
TGCAGATCCCCCGGATGTC -> GCAGATCCCCCGGATGTCC
TGCAGATCCCCCGGATTTT -> GCAGATCCCCCGGATTTTA
TGCATATCTTGCCTTAAAA -> GCATATCTTGCCTTAAAAG
TGCATATTCTTGCCAGAAA -> GCATATTCTTGCCAGAAAA
TGCATCACATACGTGTCCG -> GCATCACATACGTGTCCGT
TGCATCGAGAACGTTCGTT -> GCATCGAGAACGTTCGTTT
TGCATGGGGTTTGCAGATC -> GCATGGGGTTTGCAGATCC
TGCCAGAAAATTTTTACTA -> GCCAGAAAATTTTTACTAG
TGCCAGCAATGCGAGCTAT -> GCCAGCAATGCGAGCTATG
TGCCAGTAATGACTTATGG -> GCCAGTAATGACTTATGGA
TGCCATTCAATAGACGGTT -> GCCATTCAATAGACGGTTC
TGCCCCAATGATCCCAAGG -> GCCCCAATGATCCCAAGGG
TGCCGGAGGCTCGCCCCCT -> GCCGGAGGCTCGCCCCCTG
TGCCTCAACGGGTTTGAAT -> GCCTCAACGGGTTTGAATT
TGCCTTAAAAGTAACGTTG -> GCCTTAAAAGTAACGTTGC
TGCCTTAACTCTGGCCTTG -> GCCTTAACTCTGGCCTTGC
TGCGAAATTAGTGGGGGGA -> GCGAAATTAGTGGGGGGAT
TGCGAGATCCGCACCTCCG -> GCGAGATCCGCACCTCCGT
TGCGAGCTATGTCGAGTCA -> GCGAGCTATGTCGAGTCAG
TGCGATCCAGACGCCCCCT -> GCGATCCAGACGCCCCCTC
TGCGCACAAACTGTTCACA -> GCGCACAAACTGTTCACAT
TGCGCGACCTATTGGTGAA -> GCGCGACCTATTGGTGAAC
TGCGCTGGTCCTGTTAGCA -> GCGCTGGTCCTGTTAGCAT
TGCGCTTAACCTCCGCGTA -> GCGCTTAACCTCCGCGTAT
TGCGGATATAAACTACGAG -> GCGGATATAAACTACGAGC
TGCGGTATCTATGCAACTA -> GCGGTATCTATGCAACTAC
TGCGGTCTGGGAAATTGTA -> GCGGTCTGGGAAATTGTAA
TGCGTAACGGTCCCACCGT -> GCGTAACGGTCCCACCGTA
TGCGTACATTGTGCCCCAA -> GCGTACATTGTGCCCCAAT
TGCGTCTGTACCTGCATAT -> GCGTCTGTACCTGCATATC
TGCTAACTGTTCTGCGTCT -> GCTAACTGTTCTGCGTCTG
TGCTCACGAAAAAGGCGAC -> GCTCACGAAAAAGGCGACC
TGCTCCACCGCGGCGGATA -> GCTCCACCGCGGCGGATAC
TGCTCTCGAGGTTTCCAGT -> GCTCTCGAGGTTTCCAGTG
TGCTGACGGGGCGTTTTGC -> GCTGACGGGGCGTTTTGCA
TGCTGCCTCAACGGGTTTG -> GCTGCCTCAACGGGTTTGA
TGCTGGAGCTCCAGACCAC -> GCTGGAGCTCCAGACCACT
TGCTGTAATGAAATGGCGG -> GCTGTAATGAAATGGCGGA
TGCTGTCATATTTACAAGT -> GCTGTCATATTTACAAGTA
TGCTTCGTGTGCACCCATC -> GCTTCGTGTGCACCCATCC
TGCTTGCACCCCCAGTTTA -> GCTTGCACCCCCAGTTTAT
TGCTTGCTCTCGAGGTTTC -> GCTTGCTCTCGAGGTTTCC
TGCTTGGATGTGATGGGTG -> GCTTGGATGTGATGGGTGT
TGGAACTCTAAGGAAACGA -> GGAACTCTAAGGAAACGAT
TGGACACAAAAATAATTCA -> GGACACAAAAATAATTCAT
TGGACGGGCTGACGGAAGT -> GGACGGGCTGACGGAAGTG
TGGAGCTCCAGACCACTGG -> GGAGCTCCAGACCACTGGA
TGGAGTAGCGATAACACGA -> GGAGTAGCGATAACACGAC
TGGATCTTATGGTTGCATC -> GGATCTTATGGTTGCATCA
TGGATGTGATGGGTGTTAG -> GGATGTGATGGGTGTTAGT
TGGCCCAACACTGCTGTAA -> GGCCCAACACTGCTGTAAT
TGGCCCAACGCAGCCTCAT -> GGCCCAACGCAGCCTCATC
TGGCCCAACGGGACATGAG -> GGCCCAACGGGACATGAGC
TGGCCCAACTGTCTACCAC -> GGCCCAACTGTCTACCACA
TGGCCTTGCTCACGAAAAA -> GGCCTTGCTCACGAAAAAG
TGGCGAGCGTGAGCGGAGC -> GGCGAGCGTGAGCGGAGCC
TGGCGAGTTATAGGCGCCA -> GGCGAGTTATAGGCGCCAG
TGGCGCAATGCGTACATTG -> GGCGCAATGCGTACATTGT
TGGCGGAACACGGTTCCTC -> GGCGGAACACGGTTCCTCC
TGGCTTCAAAATCTGCGCG -> GGCTTCAAAATCTGCGCGA
TGGCTTGGCGAGTTATAGG -> GGCTTGGCGAGTTATAGGC
TGGGAAAGCAAATTGACTT -> GGGAAAGCAAATTGACTTC
TGGGAAATTGTAAGGCTAT -> GGGAAATTGTAAGGCTATC
TGGGCACCCCCTTATGCGC -> GGGCACCCCCTTATGCGCA
TGGGGGACATGAGGTGCGC -> GGGGGACATGAGGTGCGCT
TGGGGGGATCTGCGGTATC -> GGGGGGATCTGCGGTATCT
TGGGGTTTGCAGATCCCCC -> GGGGTTTGCAGATCCCCCG
TGGGTAGCGCGTCCCGTCA -> GGGTAGCGCGTCCCGTCAC
TGGGTCACTAGATGGTCTC -> GGGTCACTAGATGGTCTCT
TGGGTGTTAGTACGGCGGC -> GGGTGTTAGTACGGCGGCC
TGGTAAAAACGAGGATCAC -> GGTAAAAACGAGGATCACG
TGGTATTATTTCTTAGACA -> GGTATTATTTCTTAGACAT
TGGTCCTGTTAGCATACAT -> GGTCCTGTTAGCATACATG
TGGTCTCTAGCTCCGTTTC -> GGTCTCTAGCTCCGTTTCA
TGGTGAACTCACTAGTAGC -> GGTGAACTCACTAGTAGCT
TGGTGCGGTCTGGGAAATT -> GGTGCGGTCTGGGAAATTG
TGGTTGCATCACATACGTG -> GGTTGCATCACATACGTGT
TGTAAGGCTATCTTGATCT -> GTAAGGCTATCTTGATCTG
TGTAATGAAATGGCGGAAC -> GTAATGAAATGGCGGAACA
TGTACCTGCATATCTTGCC -> GTACCTGCATATCTTGCCT
TGTAGATTCCACTGATCTC -> GTAGATTCCACTGATCTCG
TGTAGTGCGAGATCCGCAC -> GTAGTGCGAGATCCGCACC
TGTATATACCGCCTCGACT -> GTATATACCGCCTCGACTA
TGTATTTTTTTGTCAAATT -> GTATTTTTTTGTCAAATTA
TGTCAAATTAAACAGCACG -> GTCAAATTAAACAGCACGG
TGTCACCCTGAGTACTCCT -> GTCACCCTGAGTACTCCTA
TGTCATATTTACAAGTAGG -> GTCATATTTACAAGTAGGT
TGTCCGCCCTAACTAAAAA -> GTCCGCCCTAACTAAAAAA
TGTCCGTCACGGCGGTCTC -> GTCCGTCACGGCGGTCTCT
TGTCGAGTCAGTTCACTCC -> GTCGAGTCAGTTCACTCCC
TGTCTTATACCCGATAGTA -> GTCTTATACCCGATAGTAA
TGTCTTGAGTCTGGCTTCA -> GTCTTGAGTCTGGCTTCAA
TGTGATGGGTGTTAGTACG -> GTGATGGGTGTTAGTACGG
TGTGCACCCATCCCTTCGG -> GTGCACCCATCCCTTCGGA
TGTGCCATTCAATAGACGG -> GTGCCATTCAATAGACGGT
TGTGCCCCAATGATCCCAA -> GTGCCCCAATGATCCCAAG
TGTGCTCCACCGCGGCGGA -> GTGCTCCACCGCGGCGGAT
TGTGGCCCAACACTGCTGT -> GTGGCCCAACACTGCTGTA
TGTGGCCCAACGCAGCCTC -> GTGGCCCAACGCAGCCTCA
TGTGGCCCAACGGGACATG -> GTGGCCCAACGGGACATGA
TGTGGCCCAACTGTCTACC -> GTGGCCCAACTGTCTACCA
TGTGGCGCAATGCGTACAT -> GTGGCGCAATGCGTACATT
TGTTAGCATACATGGATCT -> GTTAGCATACATGGATCTT
TGTTAGTACGGCGGCCAGG -> GTTAGTACGGCGGCCAGGG
TGTTATAAATTAAGGTTCC -> GTTATAAATTAAGGTTCCT
TGTTCACATCCCATCCCGA -> GTTCACATCCCATCCCGAC
TGTTCCCTGTGCTCCACCG -> GTTCCCTGTGCTCCACCGC
TGTTCTGCGTCTGTACCTG -> GTTCTGCGTCTGTACCTGC
TGTTGTAGTGCGAGATCCG -> GTTGTAGTGCGAGATCCGC
TTAAAAGTAACGTTGCTGT -> TAAAAGTAACGTTGCTGTC
TTAAACAGCACGGGGCTAG -> TAAACAGCACGGGGCTAGG
TTAACCTCCGCGTATCGTA -> TAACCTCCGCGTATCGTAC
TTAACTCTGGCCTTGCTCA -> TAACTCTGGCCTTGCTCAC
TTAAGGTTCCTAGACTTGA -> TAAGGTTCCTAGACTTGAT
TTAATCCCTAAAAAATGTG -> TAATCCCTAAAAAATGTGG
TTACAAGTAGGTCGATGAT -> TACAAGTAGGTCGATGATA
TTACCCCTGGACACAAAAA -> TACCCCTGGACACAAAAAT
TTACCGGTGCTGGAGCTCC -> TACCGGTGCTGGAGCTCCA
TTACCTTAGGGCCCTGACA -> TACCTTAGGGCCCTGACAG
TTACTAGCGATGGGGGACA -> TACTAGCGATGGGGGACAT
TTAGACATACGGGCAAACC -> TAGACATACGGGCAAACCA
TTAGCATACATGGATCTTA -> TAGCATACATGGATCTTAT
TTAGCATCGTCCTGGTGCG -> TAGCATCGTCCTGGTGCGG
TTAGCTCGGCGTCCGGGAT -> TAGCTCGGCGTCCGGGATT
TTAGGCTAAAGCCACTTCC -> TAGGCTAAAGCCACTTCCA
TTAGGGCCCTGACAGCTAC -> TAGGGCCCTGACAGCTACA
TTAGTACGGCGGCCAGGGT -> TAGTACGGCGGCCAGGGTC
TTAGTCAGCGCTAAAAAAT -> TAGTCAGCGCTAAAAAATG
TTAGTGGGGGGATCTGCGG -> TAGTGGGGGGATCTGCGGT
TTATAAATTAAGGTTCCTA -> TATAAATTAAGGTTCCTAG
TTATACCCGATAGTAACAG -> TATACCCGATAGTAACAGC
TTATAGGCGCCAGCAAAGG -> TATAGGCGCCAGCAAAGGG
TTATCCGAGGCAGGCAATC -> TATCCGAGGCAGGCAATCC
TTATGCGAAATTAGTGGGG -> TATGCGAAATTAGTGGGGG
TTATGCGCACAAACTGTTC -> TATGCGCACAAACTGTTCA
TTATGGACGGGCTGACGGA -> TATGGACGGGCTGACGGAA
TTATGGTTGCATCACATAC -> TATGGTTGCATCACATACG
TTATTCGGCGGTATTCTTA -> TATTCGGCGGTATTCTTAG
TTATTTCTTAGACATACGG -> TATTTCTTAGACATACGGG
TTCAAAATCTGCGCGACCT -> TCAAAATCTGCGCGACCTA
TTCAACGAAGGCGGATGTC -> TCAACGAAGGCGGATGTCT
TTCAATAGACGGTTCTCTT -> TCAATAGACGGTTCTCTTC
TTCACAAATGTATATACCG -> TCACAAATGTATATACCGC
TTCACAGAGTGCCGGAGGC -> TCACAGAGTGCCGGAGGCT
TTCACATCCCATCCCGACC -> TCACATCCCATCCCGACCC
TTCACATCGGGGCGGACGT -> TCACATCGGGGCGGACGTA
TTCACTCCCCGTTCCTGCC -> TCACTCCCCGTTCCTGCCT
TTCATAATGCTTCGTGTGC -> TCATAATGCTTCGTGTGCA
TTCATCGCCCCCAGCTAAG -> TCATCGCCCCCAGCTAAGT
TTCATGTCACCCTGAGTAC -> TCATGTCACCCTGAGTACT
TTCCAACCTCGGCGGCCCT -> TCCAACCTCGGCGGCCCTT
TTCCACACTTATTCGGCGG -> TCCACACTTATTCGGCGGT
TTCCACTGATCTCGAATTT -> TCCACTGATCTCGAATTTG
TTCCAGAGTGTTCCCTGTG -> TCCAGAGTGTTCCCTGTGC
TTCCAGTGCTGACGGGGCG -> TCCAGTGCTGACGGGGCGT
TTCCCATAACACTATCCCG -> TCCCATAACACTATCCCGG
TTCCCCAGTGGGCACCCCC -> TCCCCAGTGGGCACCCCCT
TTCCCTGTGCTCCACCGCG -> TCCCTGTGCTCCACCGCGG
TTCCTAGACTTGATACGCA -> TCCTAGACTTGATACGCAA
TTCCTCCGTTATCCGAGGC -> TCCTCCGTTATCCGAGGCA
TTCCTGCCTTAACTCTGGC -> TCCTGCCTTAACTCTGGCC
TTCGAGCCTAAAAAATGTG -> TCGAGCCTAAAAAATGTGG
TTCGATAATGCTTGCACCC -> TCGATAATGCTTGCACCCC
TTCGGAAGGGAGGGCGGCT -> TCGGAAGGGAGGGCGGCTG
TTCGGCGGTATTCTTAGCT -> TCGGCGGTATTCTTAGCTC
TTCGTGTGCACCCATCCCT -> TCGTGTGCACCCATCCCTT
TTCGTTTAGGCTAAAGCCA -> TCGTTTAGGCTAAAGCCAC
TTCTAAGATTTGCATATTC -> TCTAAGATTTGCATATTCT
TTCTCAGTGCCAGCAATGC -> TCTCAGTGCCAGCAATGCG
TTCTCTTCACAGAGTGCCG -> TCTCTTCACAGAGTGCCGG
TTCTGCGTCTGTACCTGCA -> TCTGCGTCTGTACCTGCAT
TTCTGTGGCGCAATGCGTA -> TCTGTGGCGCAATGCGTAC
TTCTTAGACATACGGGCAA -> TCTTAGACATACGGGCAAA
TTCTTAGCTCGGCGTCCGG -> TCTTAGCTCGGCGTCCGGG
TTCTTCCAACCTCGGCGGC -> TCTTCCAACCTCGGCGGCC
TTCTTGCCAGAAAATTTTT -> TCTTGCCAGAAAATTTTTA
TTCTTTGCAGATCCCCCGG -> TCTTTGCAGATCCCCCGGA
TTGAATTGCATGGGGTTTG -> TGAATTGCATGGGGTTTGC
TTGACTTCTTCCAACCTCG -> TGACTTCTTCCAACCTCGG
TTGAGTAGGCGGTAGGCAC -> TGAGTAGGCGGTAGGCACT
TTGAGTCTGGCTTCAAAAT -> TGAGTCTGGCTTCAAAATC
TTGATACGCAAATCAAGAG -> TGATACGCAAATCAAGAGG
TTGATCTGCCAGTAATGAC -> TGATCTGCCAGTAATGACT
TTGCACCCCCAGTTTATGC -> TGCACCCCCAGTTTATGCG
TTGCAGATCCCCCGGATAT -> TGCAGATCCCCCGGATATC
TTGCAGATCCCCCGGATCA -> TGCAGATCCCCCGGATCAC
TTGCAGATCCCCCGGATGT -> TGCAGATCCCCCGGATGTC
TTGCAGATCCCCCGGATTT -> TGCAGATCCCCCGGATTTT
TTGCATATTCTTGCCAGAA -> TGCATATTCTTGCCAGAAA
TTGCATCACATACGTGTCC -> TGCATCACATACGTGTCCG
TTGCATGGGGTTTGCAGAT -> TGCATGGGGTTTGCAGATC
TTGCCAGAAAATTTTTACT -> TGCCAGAAAATTTTTACTA
TTGCCTTAAAAGTAACGTT -> TGCCTTAAAAGTAACGTTG
TTGCTCACGAAAAAGGCGA -> TGCTCACGAAAAAGGCGAC
TTGCTCTCGAGGTTTCCAG -> TGCTCTCGAGGTTTCCAGT
TTGCTGTCATATTTACAAG -> TGCTGTCATATTTACAAGT
TTGCTTGCTCTCGAGGTTT -> TGCTTGCTCTCGAGGTTTC
TTGGATGTGATGGGTGTTA -> TGGATGTGATGGGTGTTAG
TTGGCGAGTTATAGGCGCC -> TGGCGAGTTATAGGCGCCA
TTGGGTAGCGCGTCCCGTC -> TGGGTAGCGCGTCCCGTCA
TTGGTGAACTCACTAGTAG -> TGGTGAACTCACTAGTAGC
TTGTAAGGCTATCTTGATC -> TGTAAGGCTATCTTGATCT
TTGTAGTGCGAGATCCGCA -> TGTAGTGCGAGATCCGCAC
TTGTATTTTTTTGTCAAAT -> TGTATTTTTTTGTCAAATT
TTGTCAAATTAAACAGCAC -> TGTCAAATTAAACAGCACG
TTGTGCCCCAATGATCCCA -> TGTGCCCCAATGATCCCAA
TTTAATCCCTAAAAAATGT -> TTAATCCCTAAAAAATGTG
TTTACAAGTAGGTCGATGA -> TTACAAGTAGGTCGATGAT
TTTACCCCTGGACACAAAA -> TTACCCCTGGACACAAAAA
TTTACCGGTGCTGGAGCTC -> TTACCGGTGCTGGAGCTCC
TTTACTAGCGATGGGGGAC -> TTACTAGCGATGGGGGACA
TTTAGGCTAAAGCCACTTC -> TTAGGCTAAAGCCACTTCC
TTTAGTCAGCGCTAAAAAA -> TTAGTCAGCGCTAAAAAAT
TTTATGCGAAATTAGTGGG -> TTATGCGAAATTAGTGGGG
TTTCAACGAAGGCGGATGT -> TTCAACGAAGGCGGATGTC
TTTCCAGAGTGTTCCCTGT -> TTCCAGAGTGTTCCCTGTG
TTTCCAGTGCTGACGGGGC -> TTCCAGTGCTGACGGGGCG
TTTCCCCAGTGGGCACCCC -> TTCCCCAGTGGGCACCCCC
TTTCGAGCCTAAAAAATGT -> TTCGAGCCTAAAAAATGTG
TTTCGATAATGCTTGCACC -> TTCGATAATGCTTGCACCC
TTTCTTAGACATACGGGCA -> TTCTTAGACATACGGGCAA
TTTGAATTGCATGGGGTTT -> TTGAATTGCATGGGGTTTG
TTTGAGTAGGCGGTAGGCA -> TTGAGTAGGCGGTAGGCAC
TTTGCAGATCCCCCGGATA -> TTGCAGATCCCCCGGATAT
TTTGCAGATCCCCCGGATC -> TTGCAGATCCCCCGGATCA
TTTGCAGATCCCCCGGATG -> TTGCAGATCCCCCGGATGT
TTTGCAGATCCCCCGGATT -> TTGCAGATCCCCCGGATTT
TTTGCATATTCTTGCCAGA -> TTGCATATTCTTGCCAGAA
TTTGTCAAATTAAACAGCA -> TTGTCAAATTAAACAGCAC
TTTTACTAGCGATGGGGGA -> TTTACTAGCGATGGGGGAC
TTTTAGTCAGCGCTAAAAA -> TTTAGTCAGCGCTAAAAAA
TTTTGCAGATCCCCCGGAT -> TTTGCAGATCCCCCGGATT
TTTTGTCAAATTAAACAGC -> TTTGTCAAATTAAACAGCA
TTTTTACTAGCGATGGGGG -> TTTTACTAGCGATGGGGGA
TTTTTGTCAAATTAAACAG -> TTTTGTCAAATTAAACAGC
TTTTTTGTCAAATTAAACA -> TTTTTGTCAAATTAAACAG
TTTTTTTGTCAAATTAAAC -> TTTTTTGTCAAATTAAACA
